f: .
fabian: Of, pertaining to, or in the manner of, the Roman general,Quintus Fabius Maximus Verrucosus; cautious; dilatory; avoiding adecisive contest. Fabian policy, a policy like that of FabiusMaximus, who, by carefully avoiding decisive contests, foiledHannibal, harassing his army by marches, countermarches, andambuscades; a policy of delays and cautions.
fable: To compose fables; hence, to write or speak fiction ; to writeor utter what is not true. "He Fables not." Shak.Vain now the tales which fabling poets tell. Prior.He fables, yet speaks truth. M. Arnold.
fabliau: One of the metrical tales of the Trouvères, or early poets ofthe north of France.
fabric: To frame; to built; to construct. [Obs.] "Fabric theirmansions." J. Philips.
fabricator: One who fabricates; one who constructs or makes.The fabricator of the works of Ossian. Mason.
fabulist: One who invents or writes fables.
facade: The front of a building; esp., the principal front, having somearchitectural pretensions. Thus a church is said to have its facadeunfinished, though the interior may be in use.
face: Ten degrees in extent of a sign of the zodiac. Chaucer.
faced: Having (such) a face, or (so many) faces; as, smooth-faced,two-faced.
facet: A smooth circumscribed surface; as, the articular facet of abone.
faceted: Having facets.
facetiae: Witty or humorous writings or saying; witticisms; merryconceits.
facia: See Fascia.
facial: Of or pertaining to the face; as, the facial artery, vein, ornerve.-- Fa"cial*ly, adv. Facial angle (Anat.), the angle, in a skull,included between a straight line (ab, in the illustrations), from themost prominent part of the forehead to the front efge of the upperjaw bone, and another (cd) from this point to the center of theexternal auditory opening. See Gnathic index, under Gnathic.
facilitate: To make easy or less difficult; to free from difficulty orimpediment; to lessen the labor of; as, to facilitate the executionof a task.To invite and facilitate that line of proceeding which the times callfor. I. Taylor.
facilitation: The act of facilitating or making easy.
facing: The finishing of any face of a wall with material differentfrom that of which it is chiefly composed, or the coating or materialso used.
facsimile: A copy of anything made, either so as to be deceptive or so asto give every part and detail of the original; an exact copy orlikeness. Facsimile telegraph, a telegraphic apparatus reproducingmessages in autograph.
faction: One of the divisions or parties of charioteers (distinguishedby their colors) in the games of the circus.
factitious: Made by art, in distinction from what is produced by nature;artificial; sham; formed by, or adapted to, an artificial orconventional, in distinction from a natural, standard or rule; notnatural; as, factitious cinnabar or jewels; a factitious taste.-- Fac-ti"tious*ly, adv.-- Fac*ti"tious-ness, n.He acquires a factitious propensity, he forms an incorrigible habit,of desultory reading. De Quincey.
factor: One who transacts business for another; an agent; a substitute;especially, a mercantile agent who buys and sells goods and transactsbusiness for others in commission; a commission merchant orconsignee. He may be a home factor or a foreign factor. He may buyand sell in his own name, and he is intrusted with the possession andcontrol of the goods; and in these respects he differs from a broker.Story. Wharton.My factor sends me word, a merchant's fled That owes me for a hundredtun of wine. Marlowe.
factorial: Related to factorials.
factotum: A person employed to do all kinds of work or business. B.Jonson.
factual: Relating to, or containing, facts. [R.]
faculty: The body of person to whom are intrusted the government andinstruction of a college or university, or of one of its departments;the president, professors, and tutors in a college. Dean of faculty.See under Dean.-- Faculty of advocates. (Scot.) See under Advocate.
fad: A hobby ; freak; whim.-- Fad"dist, n.It is your favorite fad to draw plans. G. Eliot.
fade: Weak; insipid; tasteless; commonplace. [R.] "Passages that aresomewhat fade." Jeffrey.His masculine taste gave him a sense of something fade and ludicrous.De Quincey.
faded: That has lost freshness, color, or brightness; grown dim. "Hisfaded cheek." Milton.Where the faded moon Made a dim silver twilight. Keats.
faecal: See Fecal.
faeces: Excrement; ordure; also, settlings; sediment after infusion ordistillation. [Written also feces.]
faery: Fairy. [Archaic] Spenser.
fag: A knot or coarse part in cloth. [Obs.]
fagot: A bassoon. See Fagotto.
fahrenheit: Conforming to the scale used by Gabriel Daniel Fahrenheit inthe graduation of his thermometer; of or relating to Fahrenheit'sthermometric scale.-- n.
faience: Glazed earthenware; esp., that which is decorated in color.
faille: A soft silk, heavier than a foulard and not glossy.
fain: With joy; gladly; -- with wold.He would fain have filled his belly with the husks that the swine dideat. Luke xv. 16.Fain Would I woo her, yet I dare not. Shak.
faineant: Doing nothing; shiftless.-- n.
faint: The act of fainting, or the state of one who has fainted; aswoon. [R.] See Fainting, n.The saint, Who propped the Virgin in her faint. Sir W. Scott.
faintly: In a faint, weak, or timidmanner.
fair: Without sudden change of direction or curvature; smooth;fowing; -- said of the figure of a vessel, and of surfaces, waterlines, and other lines.
fairing: A present; originally, one given or purchased at a fair. Gay.Fairing box, a box receiving savings or small sums of money. HannahMore.
fairness: The state of being fair, or free form spots or stains, as ofthe skin; honesty, as of dealing; candor, as of an argument, etc.
fairway: The navigable part of a river, bay, etc., through which vesselsenter or depart; the part of a harbor or channel ehich is kept openand unobstructed for the passage of vessels. Totten. the rough.
fairyland: The imaginary land or abode of fairies.
faith: By my faith; in truth; verily.
fake: One of the circles or windings of a cable or hawser, as it liesin a coil; a single turn or coil.
faker: One who fakes something, as a thief, a peddler of petty things,a workman who dresses things up, etc. [Slang]
fakir: An Oriental religious ascetic or begging monk. [Written alsofaquir anf fakeer.]
falcon: An ancient form of cannon. Chanting falcon. (Zoöl.) See underChanting.
falconer: A person who breeds or trains hawks for taking birds or game;one who follows the sport of fowling with hawks. Johnson.
fallacious: Embodying or pertaining to a fallacy; illogical; fitted todeceive; misleading; delusive; as, fallacious arguments or reasoning.-- Fal*la"cious*ly, adv. -Fal*la"cious*ness, n.
fallacy: An argument, or apparent argument, which professes to bedecisive of the matter at issue, while in reality it is not; asophism.
fallen: Dropped; prostrate; degraded; ruined; decreased; dead.Some ruined temple or fallen monument. Rogers.
fallibility: The state of being fallible; liability to deceive or to bedeceived; as, the fallibity of an argument or of an adviser.
fallible: Liable to fail, mistake, or err; liable to deceive or to bedeceived; as, all men are fallible; our opinions and hopes arefallible.
fallibly: In a fallible manner.
fallow: Left untilled or unsowed after plowing; uncultivated; as,fallow ground. Fallow chat, Fallow finch (Zoöl.), a small Europeanbird, the wheatear (Saxicola ænanthe). See Wheatear.
fallowness: A well or opening, through the successive floors of a warehouseor manufactory, through which goods are raised or lowered. [U.S.]Bartlett.
false: Not in tune. False arch (Arch.), a member having the appearanceof an arch, though not of arch construction.-- False attic, an architectural erection above the main cornice,concealing a roof, but not having windows or inclosing rooms.-- False bearing, any bearing which is not directly upon a verticalsupport; thus, the weight carried by a corbel has a false bearing.-- False cadence, an imperfect or interrupted cadence.-- False conception (Med.), an abnormal conception in which a mole,or misshapen fleshy mass, is produced instead of a properly organizedfetus.-- False croup (Med.), a spasmodic affection of the larynx attendedwith the symptoms of membranous croup, but unassociated with thedeposit of a fibrinous membrane.-- False door or window (Arch.), the representation of a door orwindow, inserted to complete a series of doors or windows or to givesymmetry.-- False fire, a combustible carried by vessels of war, chiefly forsignaling, but sometimes burned for the purpose of deceiving anenemy; also, a light on shore for decoying a vessel to destruction.-- False galena. See Blende.-- False imprisonment (Law), the arrest and imprisonment of a personwithout warrant or cause, or contrary to law; or the unlawfuldetaining of a person in custody.-- False keel (Naut.), the timber below the main keel, used to serveboth as a protection and to increase the shio's lateral resistance.-- False key, a picklock.-- False leg. (Zoöl.) See Proleg.-- False membrane (Med.), the fibrinous deposit formed in croup anddiphtheria, and resembling in appearance an animal membrane.-- False papers (Naut.), documents carried by a ship giving falserepresentations respecting her cargo, destination, ect., for thepurpose of deceiving.-- False passage (Surg.), an unnatural passage leading off from anatural canal, such as the urethra, and produced usually by theunskillful introduction of instruments.-- False personation (Law), the intentional false assumption of thename and personality of another.-- False pretenses (Law), false representations concerning past orpresent facts and events, for the purpose of defrauding another.-- False rail (Naut.), a thin piece of timber placed on top of thehead rail to strengthen it.-- False relation (Mus.), a progression in harmony, in which acertain note in a chord appears in the next chord prefixed by a flator sharp.-- False return (Law), an untrue return made to a process by theofficer to whom it was delivered for execution.-- False ribs (Anat.), the asternal rebs, of which there are fivepairs in man.-- False roof (Arch.), the space between the upper ceiling and theroof. Oxford Gloss.-- False token, a false mark or other symbol, used for fraudulentpurposes.-- False scorpion (Zoöl.), any arachnid of the genus Chelifer. SeeBook scorpion.-- False tack (Naut.), a coming up into the wind and filling awayagain on the same tack.-- False vampire (Zoöl.), the Vampyrus spectrum of South America,formerly erroneously supposed to have blood-sucking habits; -- calledalso vampire, and ghost vampire. The genuine blood-sucking batsbelong to the genera Desmodus and Diphylla. See Vampire.-- False window. (Arch.) See False door, above.-- False wing. (Zoöl.) See Alula, and Bastard wing, under Bastard.-- False works (Civil Engin.), construction works to facilitate theerection of the main work, as scaffolding, bridge centering, etc.
falsely: In a false manner; erroneously; not truly; perfidiously ortreacherously. "O falsely, falsely murdered." Shak.Oppositions of science, falsely so called. 1 Tim. vi. 20.Will ye steal, murder . . . and swear falsely Jer. vii. 9.
falseness: The state of being false; contrariety to the fact; inaccuracy;want of integrity or uprightness; double dealing; unfaithfulness;treachery; perfidy; as, the falseness of a report, a drawing, or asinger's notes; the falseness of a man, or of his word.
falsetto: A false or artificial voice; that voice in a man which liesabove his natural voice; the male counter tenor or alto voice. SeeHead voice, under Voice.
falsification: The showing an item of charge in an account to be wrong. Story.
falsifier: One who falsifies, or gives to a thing a deceptive appearance;a liar.
falsify: To avoid or defeat; to prove false, as a judgment. Blackstone.
falter: To thrash in the chaff; also, to cleanse or sift, as barley.[Prov. Eng.] Halliwell.
faltering: Hesitating; trembling. "With faltering speech." Milton.-- n.
familiar: A confidential officer employed in the service of the tribunal,especially in apprehending and imprisoning the accused.
familiarization: The act or process of making familiar; the result of becomingfamiliar; as, familiarization with scenes of blood.
familiarly: In a familiar manner.
family: A groupe of organisms, either animal or vegetable, related bycertain points of resemblance in structure or development, morecomprehensive than a genus, because it is usually based on fewer orless pronounced points of likeness. In zoölogy a family is lesscomprehesive than an order; in botany it is often considered the samething as an order. Family circle. See under Circle.-- Family man. (a) A man who has a family; esp., one who has a wifeand children living with him andd dependent upon him. (b) A man ofdomestic habits. "The Jews are generally, when married, mostexemplary family men." Mayhew.-- Family of curves or surfaces (Geom.), a group of curves orsurfaces derived from a single equation.-- In a family way, like one belonging to the family. "Why don't weask him and his ladies to come over in a family way, and dine withsome other plain country gentlefolks" Thackeray.-- In the family way, pregnant. [Colloq.]
famine: General scarcity of food; dearth; a want of provisions;destitution. "Worn with famine." Milton.There was a famine in the land. Gen. xxvi. 1.Famine fever (Med.), typhus fever.
famous: Celebrated in fame or public report; renowned; mach talked of;distinguished in story; -- used in either a good or a bad sense,chiefly the former; often followed by for; as, famous for erudition,for eloquence, for military skill; a famous pirate.Famous for a scolding tongue. Shak.
famously: In a famous manner; in a distinguished degree; greatly;splendidly.Then this land was famously enriched With politic grave counsel.Shak.
fanatic: Pertaining to, or indicating, fanaticism; extravagant inopinions; ultra; unreasonable; excessively enthusiastic, especiallyon religious subjects; as, fanatic zeal; fanatic notions.But Faith, fanatic Faith, once wedded fast To some dear falsehood,hugs it to the last. T. Moore.
fanatical: Characteristic of, or relating to, fanaticism; fanatic. -Fa*nat"ic*al*ly, adv.-- Fa*nat"ic*al*ness, n.
fanaticism: Excessive enthusiasm, unreasoning zeal, or wild and extravagantnotions, on any subject, especially religion; religious frenzy.
fancywork: Ornamental work with a needle or hook, as embroidery,crocheting, netting, etc.
fane: A temple; a place consecrated to religion; a church. [Poet.]Such to this British Isle, her Christian fanes. Wordsworth.
fanfare: A flourish of trumpets, as in coming into the lists, etc.;also, a short and lively air performed on hunting horns during thechase.The fanfare announcing the arrival of the various Christian princes.Sir W. Scott.
fanfaronade: A swaggering; vain boasting; ostentation; a bluster. Swift.
fang: The tusk of an animal, by which the prey is seized and held ortorn; a long pointed tooth; esp., one of the usually erectile,venomous teeth of serpents. Also, one of the falcers of a spider.Since I am a dog, beware my fangs. Shak.
fanged: Having fangs or tusks; as, a fanged adder. Also usedfiguratively.
fantasia: A continuous composition, not divided into what are calledmovements, or governed by the ordinary rules of musical design, butin which the author's fancy roves unrestricted by set form.
fantastic: A person given to fantastic dress, manners, etc.; an eccentricperson; a fop. Milton.Our fantastics, who, having a fine watch, take all ocasions to drowit out to be seen. Fuller.
fantastical: Fanciful; unreal; whimsical; capricious; fantastic.
fantasticality: Fantastically. [Obs.]
fantastically: In a fantastic manner.the letter A, in scarlet, fantastically embroidered with gold thread,upon her bosom. Hawthorne.
fantasy: To have a fancy for; to be pleased with; to like; to fancy.[Obs.] Cavendish.Which he doth most fantasy. Robynson (More's Utopia).
faquir: See Fakir.
far: A young pig, or a litter of pigs.
farad: The standard unit of electrical capacity; the capacity of acondenser whose charge, having an electro-motive force of one volt,is equal to the amount of electricity which, with the sameelectromotive force, passes through one ohm in one second; thecapacity, which, charged with one coulomb, gives an electro-motiveforce of one volt.
farce: Stuffing, or mixture of viands, like that used on dressing afowl; forcemeat.
farcical: Pertaining to farce; appropriated to farce; ludicrous;unnatural; unreal.They deny the characters to be farcical, because they are Gay.-- Far"ci*cal*ly, adv. -Far"ci*cal*ness, n.
farewell: Go well; good-by; adieu; -- originally applied to a persondeparting, but by custom now applied both to those who depart andthose who remain. It is often separated by the pronoun; as, fare youwell; and is sometimes used as an expression of separation only; as,farewell the year; farewell, ye sweet groves; that is, I bid youfarewell.So farewell hope, and with hope, farewell fear. Milton.Fare thee well! and if forever, Still forever fare thee well. Byron.
farina: Pollen. [R.] Craig.
farm: A lease of the imposts on particular goods; as, the sugar farm,the silk farm.Whereas G. H. held the farm of sugars upon a rent of 10,000 marks perannum. State Trials (1196).
farmable: Capable of being farmed.
farmer: One who farms; as:(a) One who hires and cultivates a farm; a cultivator of leasedground; a tenant. Smart.(b) One who is devoted to the tillage of the soil; one who cultivatesa farm; an agriculturist; a husbandman.(c) One who takes taxes, customs, excise, or other duties, tocollect, either paying a fixed annuual rent for the privilege; as, afarmer of the revenues.(d) (Mining) The lord of the field, or one who farms the lot and copeof the crown. Farmer-general Etym: [F. fermier-general], one to whomthe right of levying certain taxes, in a particular district, wasfarmed out, under the former French monarchy, for a given sum paiddown.-- Farmers' satin, a light material of cotton and worsted, used forcoat linings. McElrath.-- The king's farmer (O. Eng. Law), one to whom the collection of aroyal revenue was farmed out. Burrill.
farmhouse: A dwelling house on a farm; a farmer's residence.
farming: Pertaining to agriculture; devoted to, adapted to, or engagedin, farming; as, farming tools; farming land; a farming community.
farmstead: A farm with the building upon it; a homestead on a farm.Tennyson.With its pleasant groves and farmsteads. Carlyle.
farmyard: The yard or inclosure attached to a barn, or the space inclosedby the farm buildings.
faro: A gambling game at cardds, in whiich all the other players playagainst the dealer or banker, staking their money upon the order inwhich the cards will lie and be dealt from the pack. Faro bank, thecapital which the proprietor of a farotable ventures in the game;also, the place where a game of faro is played. Hoyle.
farraginous: Formed of various materials; mixed; as, a farraginous mountain.[R.] Kirwan.AA farraginous concurrence of all conditions, tempers, sexes, andages. Sir T. Browne.
farrago: A mass ccomposed of various materials confusedly mixed; amedley; a mixture.A confounded farrago of doubts, fears, hopes, wishes, and all theflimsy furniture of a country miss's brain. Sheridan.
farrier: Defn:
farrow: A little of pigs. Shak.
farsighted: Hypermetropic.
farsightedness: Hypermetropia.
farther: To help onward. [R.] See Further.
farthermost: Most distant or remote; as, the farthest degree. See Furthest.
farthest: Most distant or remote; as, the farthest degree.  See Furthest.
farthingale: A hoop skirt or hoop petticoat, or other light, elasticmaterial, used to extend the petticoat.We'll revel it as bravely as the best, . . . With ruffs and cuffs,and farthingales and things. Shak.
fasces: A bundle of rods, having among them an ax with the bladeprojecting, borne before the Roman magistrates as a badge of theirauthority.
fascia: A flat member of an order or building, like a flat band orbroad fillet; especially, one of the three bands which make up thearchitrave, in the Ionic order. See Illust. of Column.
fascicle: A small bundle or collection; a compact cluster; as, a fascicleof fibers; a fascicle of flowers or roots.
fascicled: Growing in a bundle, tuft, or close cluster; as, the fascicledleaves of the pine or larch; the fascicled roots of the dahlia;fascicled muscle fibers; fascicled tufts of hair.
fascicule: A small bunch or bundle; a fascicle; as, a fascicule of fibers,hairs, or spines.
fashionable: A person who conforms to the fashions; -- used chiefly in theplural.
fashionableness: State of being fashionable.
fashionably: In a fashionable manner.
fashioner: One who fashions, forms, ar gives shape to anything. [R.]The fashioner had accomplished his task, and the dresses were broughthome. Sir W. Scott.
fast: That which fastens or holds; especially, (Naut.) a mooringrope, hawser, or chain; -- called, according to its position, a bow,head, quarter, breast, or stern fast; also, a post on a pier aroundwhich hawsers are passed in mooring.
fasten: To fix one's self; to take firm hold; to clinch; to cling.A horse leech will hardly fasten on a fish. Sir T. Browne.
fastener: One who, or that which, makes fast or firm.
fastening: Anything that binds and makes fast, as a lock, catch, bolt,bar, buckle, etc.
fastidious: Difficult to please; delicate to fault; suited with difficulty;squeamish; as, a fastidious mind or ear; a fastidious appetite.Proud youth ! fastidious of the lower world. Young.
fat: Of a character which enables the compositor to make largewages; -- said of matter containing blank, cuts, or many leads, etc.;as, a fat take; a fat page. Fat lute, a mixture of pipe clay and oilfor filling joints.
fatalism: The doctrine that all things are subject to fate, or that theytake place by inevitable necessity.
fatalist: One who maintains that all things happen by inevitablenecessity.
fatalistic: Implying, or partaking of the nature of, fatalism.
fatback: The menhaden.
fate: The three goddesses, Clotho, Lachesis, and Atropos, sometimescalled the Destinies, or Parcæwho were supposed to determine thecourse of human life. They are represented, one as holding thedistaff, a second as spinning, and the third as cutting off thethread.
fateful: Having the power of serving or accomplishing fate. "The fatefulsteel." J. Barlow.
fatherhood: The state of being a father; the character or authority of afather; paternity.
fatherland: One's native land; the native land of one's fathers orancestors.
fatherlessness: The state of being without a father.
fatherliness: The qualities of a father; parantal kindness, care, etc.
fathomable: Capable of being fathomed.
fatigable: Easily tired. [Obs.] Bailey.
fatigue: To weary with labor or any bodily or mental exertion; to harasswith toil; to exhaust the strength or endurance of; to tire.
fatly: Grossly; greasily.
fatten: To grow fat or corpulent; to grow plump, thick, or fleshy; tobe pampered.And villains fatten with the brave man's labor. Otway.
fattener: One who, or that which, fattens; that which gives fatness orfertility.
fattiness: State or quality of being fatty.
fattish: Somewhat fat; inclined to fatness.Coleridge, a puffy, anxious, obstructed-looking, fattish old man.Carlyle.
fatty: Containing fat, or having the qualities of fat; greasy; gross;as, a fatty substance. Fatty acid (Chem.), any one of the paraffinseries of monocarbonic acids, as formic acid, acetic, etc.; -- socalled because the higher members, as stearic and palmitic acids,occur in the natural fats, and are themselves fatlike substances.-- Fatty clays. See under Clay.-- Fatty degeneration (Med.), a diseased condition, in which the oilglobules, naturally present in certain organs, are so multiplied asgradually to destroy and replace the efficient parts of these organs.-- Fatty heart, Fatty liver, etc. (Med.), a heart, liver, etc.,which have been the subjects of fatty degeneration or infiltration.-- Fatty infiltration (Med.), a condition in which there is anexcessive accumulation of fat in an organ, without destruction of anyessential parts of the latter.-- Fatty tumor (Med.), a tumor consisting of fatty or adiposetissue; lipoma.
fatuity: Weakness or imbecility of mind; stupidity.Those many forms of popular fatuity. I Taylor.
faubourg: A suburb of French city; also, a district now within a city,but formerly without its walls.
fauces: The narrow passage from the mouth to the pharynx, situatedbetween the soft palate and the base of the tongue; -- called alsothe isthmus of the fauces. On either side of the passage twomembranous folds, called the pillars of the fauces, inclose thetonsils.
fault: A lost scent; act of losing the scent.Ceasing their clamorous cry till they have singled, With much ado,the cold fault cleary out. Shak.
faultily: In a faulty manner.
faultiness: Quality or state of being faulty.Round, even to faultiness. Shak.
faultless: Without fault; not defective or imperfect; free from blemish;free from incorrectness, vice, or offense; perfect; as, a faultlesspoem.Whoever thinks a faultless piece to see, Thinks what ne'er was, noris, nor e'er shall be. Pope.
faun: A god of fields and shipherds, diddering little from the satyr.The fauns are usually represented as half goat and half man.Satyr or Faun, or Sylvan. Milton.
fauna: The animals of any given area or epoch; as, the fauna ofAmerica; fossil fauna; recent fauna.
faunal: Relating to fauna.
faux: See Fauces.
favor: Partiality; bias. Bouvier.
favorer: One who favors; one who regards with kindness or friendship; awell-wisher; one who assists or promotes success or prosperity.[Written also favourer.]And come to us as favorers, not as foes. Shak.
favorite: Short curls dangling over the temples; -- fashionable in thereign of Charles II. [Obs.] Farquhar.
favoritism: The disposition to favor and promote the interest of one personor family, or of one class of men, to the neglect of others havingequal claims; partiality.A spirit of favoritism to the Bank of the United States. A. Hamilton.
fawn: A young deer; a buck or doe of the first year. See Buck.
fawner: One who fawns; a sycophant.
fawningly: In a fawning manner.
fay: A fairy; an elf. "Yellow-skirted fays." Milton.
faze: See Feeze.
fear: A variant of Fere, a mate, a companion. [Obs.] Spenser.
fearer: One who fars. Sir P. Sidney.
fearfully: In a fearful manner.
fearfulness: The state of being fearful.
fearless: Free from fear.
fearsome: . Easily frightened; timid; timorous. "A silly fearsome thing."B. Taylor
feasibility: The quality of being feasible; practicability; also, that whichis feasible; as, before we adopt a plan, let us consider itsfeasibility.Men often swallow falsities for truths, dubiosities for certainties,possibilities for feasibilities. Sir T. Browne.
feat: To form; to fashion. [Obs.]To the more mature, A glass that feated them. Shak.
feather: A longitudinal strip projecting as a fin from an object, tostrengthen it, or to enter a channel in another object and therebyprevent displacement sidwise but permit motion lengthwise; a spline.
feathered: Having a fringe of feathers, as the legs of certian birds; orof hairs, as the legs of a setter dog.
feathering: Same as Foliation.
featherless: Destitute of feathers.
featherstitch: A kind of embroidery stitch producing a branching zigzag line.
feathery: Pertaining to, or resembling, feathers; covered with, or aswith, feathers; as, feathery spray or snow. Milton.Ye feathery people of mid air. Barry Cornwall.
featureless: Having no distinct or distinctive features.
feaze: To untwist; to unravel, as the end of a rope. Johnson.
febrifugal: Having the quality of mitigating or curing fever. Boyle.
febrifuge: A medicine serving to mitigate or remove fever.-- a.
febrile: Pertaining to fever; indicating fever, or derived from it; as,febrile symptoms; febrile action. Dunglison.
february: The second month in the year, said to have been introduced intothe Roman calendar by Numa. In common years this month containstwenty-eight days; in the bissextile, or leap year, it has twenty-nine days.
fecal: relating to, or containing, dregs, feces, or ordeure; fæcal.
feces: dregs; sediment; excrement. See FÆces.
feckless: Spiritless; weak; worthless. [Scot]
fecklessness: absence of merit.[WordNet 1.5]
feculent: Foul with extraneous or impure substances; abounding withsediment or excrementitious matter; muddy; thick; turbid.Both his hands most filthy feculent. Spenser.
fecund: Fruitful in children; prolific. Graunt.
fecundate: To render fruitful or prolific; to impregnate; as, in flowersthe pollen fecundates the ovum through the stigma.
fecundation: The act by which, either in animals or plants, materialprepared by the generative organs the female organism is brought incontact with matter from the organs of the male, so that a neworganism results; impregnation; fertilization.
fed: imp. & p. p. of Feed.
federal: See Federalist.
federalism: the principles of Federalists or of federal union.
federalist: An advocate of confederation; specifically (Amer. Hist.), afriend of the Constitution of the United States at its formation andadoption; a member of the political party which favored theadministration of president Washington.
federalize: To unite in compact, as different States; to confederate forpolitical purposes; to unite by or under the Federal Constitution.Barlow.
federate: United by compact, as sovereignties, states, or nations; joinedin confederacy; leagued; confederate; as, federate nations.
federative: Uniting in a league; forming a confederacy; federal. "Afederative society." Burke.
fee: A right to the use of a superior's land, as a stipend forservices to be performed; also, the land so held; a fief.
feeble: To make feble; to enfeeble. [Obs.]Shall that victorious hand be feebled here Shak.
feebleness: The quality or condition of being feeble; debility; infirmity.That shakes for age and feebleness. Shak.
feebly: In a feeble manner.The restored church . . . contended feebly, and with half a heart.Macaulay.
feeder: An auxiliary part of a machine which supplies or leads alongthe material operated upon.
feeler: One of the sense organs or certain animals (as insects), whichare used in testing objects by touch and in searching for food; anantenna; a palp.Insects . . . perpetually feeling and searching before them withtheir feelers or antennæ. Derham.
feelingly: In a feeling manner; pathetically; sympathetically.
feet: See Foot.
feigner: One who feigns or pretends.
feint: Feigned; counterfeit. [Obs.]Dressed up into any feint appearance of it. Locke.
felicitate: Made very happy. [Archaic]I am alone felicitate In your dear highness' love. Shak.
felicitation: The act of felicitating; a wishing of joy or happiness;congratulation.
felicitous: Characterized by felicity; happy; prosperous; delightful;skilful; successful; happily applied or expressed; appropriate.Felicitous words and images. M. Arnold.-- Fe*lic"i*tous*ly, adv.-- Fe*lic"i*tous*ness, n.
feline: Catlike; of or pertaining to the genus Felis, or family Felidæ;as, the feline race; feline voracity.
fell: imp. of Fall.
fellable: Fit to be felled.
fellah: A peasant or cultivator of the soil among the Egyptians,Syrians, etc. W. M. Thomson.
feller: One who, or that which, fells, knocks or cuts down; a machinefor felling trees.
fellow: To suit with; to pair with; to match. [Obs.] Shak.
fellowship: (Eccl.) To acknowledge as of good standing, or in communionaccording to standards of faith and practice; to admit to Christianfellowship.
felon: A person who has committed a felony.
felonious: Having the quality of felony; malignant; malicious; villainous;traitorous; perfidious; in a legal sense, done with intent to commita crime; as, felonious homicide.O thievish Night, Why should'st thou, but for some felonious end, Inthy dark lantern thus close up the stars Milton.-- Fe*lo"ni`ous*ly, adv.-- Fe*lo"ni`ous*ness, n.
felony: An act on the part of the vassal which cost him his fee byforfeiture. Burrill.
felt: imp. & p. p. or a. from Feel.
female: A plant which produces only that kind of reproductive organswhich are capable of developing into fruit after impregnation orfertilization; a pistillate plant.
feminine: Any one of those words which are the appellations of females,or which have the terminations usually found in such words; as,actress, songstress, abbess, executrix.There are but few true feminines in English. Latham.
femininely: In a feminine manner. Byron.
feminineness: The quality of being feminine; womanliness; womanishness.
feminization: The act of feminizing, or the state of being feminized.
feminize: To make womanish or effeminate. Dr. H. More.
femoral: Pertaining to the femur or thigh; as, the femoral artery."Femoral habiliments." Sir W. Scott.
fen: Low land overflowed, or covered wholly or partially with water,but producing sedge, coarse grasses, or other aquatic plants; boggyland; moor; marsh.'Mid reedy fens wide spread. Wordsworth.
fence: A projection on the bolt, which passes through the tumblergates in locking and unlocking.
fencer: One who fences; one who teaches or practices the art of fencingwith sword or foil.As blunt as the fencer's foils. Shak.
fend: A fiend. [Obs.] Chaucer.
fender: One who or that which defends or protects by warding off harm;as:(a) A screen to prevent coals or sparks of an open fire from escapingto the floor.(b) Anything serving as a cushion to lessen the shock when a vesselcomes in contact with another vessel or a wharf.(c) A screen to protect a carriage from mud thrown off the wheels:also, a splashboard.(d) Anything set up to protect an exposed angle, as of a house, fromdamage by carriage wheels.
fenestration: The arrangement and proportioning of windows; -- used by modernwriters for the decorating of an architectural composition by meansof the window (and door) openings, their ornaments, and proportions.
fenian: A member of a secret organization, consisting mainly ofIrishment, having for its aim the overthrow of English rule inireland.
fenianism: The principles, purposes, and methods of the Fenians.
fennel: A perennial plant of the genus Fæniculum (F.vulgare), havingvery finely divided leaves. It is cultivated in gardens for theagreeable aromatic flavor of its seeds.Smell of sweetest fennel. Milton.A sprig of fennel was in fact the theological smelling bottle of thetender sex. S. G. Goodrich.Azorean, or Sweet, fennel, (Fæniculum dulce). It is a smaller andstouter plant than the common fennel, and is used as a pot herb.-- Dog's fennel (Anthemis Cotula), a foul-smelling European weed; --called also mayweed.-- Fennel flower (Bot.), an herb (Nigella) of the Buttercup family,having leaves finely divided, like those of the fennel. N.Damascenais common in gardens. N.sativa furnishes the fennel seed, used as acondiment, etc., in India. These seeds are the "fitches" mentioned inIsaiah (xxviii. 25).-- Fennel water (Med.), the distilled water of fennel seed. It isstimulant and carminative.-- Giant fennel (Ferula communis), has stems full of pith, which, itis said, were used to carry fire, first, by Prometheus.-- Hog's fennel, a European plant (Peucedanum officinale) lookingsomething like fennel.
fenny: Pertaining to, or inhabiting, a fen; abounding in fens; swampy;boggy. "Fenny snake." Shak.
feral: Wild; untamed; ferine; not domesticated; -- said of beasts,birds, and plants. feral child, not raised by humans
ferment: To cause ferment of fermentation in; to set in motion; toexcite internal emotion in; to heat.Ye vigorous swains! while youth ferments your blood. Pope.
fermentability: Capability of fermentation.
fermentable: Capable of fermentation; as, cider and other vegetable liquorsare fermentable.
fermentative: Causing, or having power to cause, fermentation; produced byfermentation; fermenting; as, a fermentative process.-- Fer*ment"a*tive*ly, adv.-- Fer*ment"a*tive*ness, n.
fern: Long ago. [Obs.] Chaucer.
fernery: A place for rearing ferns.
ferny: Abounding in ferns.
ferocious: Fierce; savage; wild; indicating cruelty; ravenous; rapacious;as, ferocious look or features; a ferocious lion.The humbled power of a ferocious enemy. Lowth.
ferocity: Savage wildness or fierceness; fury; cruelty; as, ferocity ofcountenance.The pride and ferocity of a Highland chief. Macaulay.
ferrara: A sword bearing the mark of one of the Ferrara family of Italy.These swords were highly esteemed in England and Scotland in the 16thand 17th centuries.
ferret: An animal of the Weasel family (Mustela or Putorius furo),about fourteen inches in length, of a pale yellow or white color,with red eyes. It is a native of Africa, but has been domesticated inEurope. Ferrets are used to drive rabbits and rats out of theirholes.
ferric: Pertaining to, derived from, or containing iron. Specifically(Chem.), denoting those compounds in which iron has a higher valencethan in the ferrous compounds; as, ferric oxide; ferric acid. Ferricacid (Chem.), an acid, H2FeO4, which is not known in the free state,but forms definite salts, analogous to the chromates and sulphates.-- Ferric oxide (Chem.), sesquioxide of iron, Fe2O3; hematite. SeeHematite.
ferrotype: A photographic picture taken on an iron plate by a collodionprocess; -- familiarly called tintype.
ferrous: Pertaining to, or derived from, iron; -- especially used ofcompounds of iron in which the iron has its lower valence; as,ferrous sulphate.
ferrule: A bushing for expanding the end of a flue to fasten it tightlyin the tube plate, or for partly filling up its mouth.
ferry: To carry or transport over a river, strait, or other narrowwater, in a boat.
ferryboat: A vessel for conveying passengers, merchandise, etc., acrossstreams and other narrow waters.
fertilely: In a fertile or fruitful manner.
fertileness: Fertility. Sir P. Sidney.
fertility: The state or quality of being fertile or fruitful;fruitfulness; productiveness; fecundity; richness; abundance ofresources; fertile invention; quickness; readiness; as, the fertilityof soil, or of imagination. "fertility of resource." E. Everett.And all her husbandry doth lie on heaps Corrupting in its ownfertility. Shak.Thy very weeds are beautiful; thy waste More rich than other climes'fertility. Byron.
fertilization: The act of fecundating or impregnating animal or vegetablegerms; esp., the process by which in flowers the pollen renders theovule fertile, or an analogous process in flowerless plants;fecundation; impregnation. Close fertilization (Bot.), thefertilization of pistils by pollen derived from the stamens of thesame blossom.-- Cross fertilization, fertilization by pollen from some otherblossom. See under Cross, a.
ferule: A flat piece of wood, used for striking, children, esp. on thehand, in punishment.
fervency: The state of being fervent or warm; ardor; warmth of feeling ordevotion; eagerness.When you pray, let it be with attention, with fervency, and withperseverance. Wake.
fescue: A grass of the genus Festuca. Fescue grass (Bot.), a genus ofgrasses (Festuca) containing several species of importance inagriculture. Festuca ovina is sheep's fescue; F. elatior is meadowfescue.
fest: The fist. [Obs.] Chaucer.
festal: Of or pertaining to a holiday or a feast; joyous; festive.You bless with choicer wine the festal day. Francis.
festally: Joyously; festively; mirthfully.
fester: To cause to fester or rankle.For which I burnt in inward, swelt'ring hate, And fstered rankingmalice in my breast. Marston.
festival: Pertaining to a fest; festive; festal; appropriate to afestival; joyous; mirthful.I cannot woo in festival terms. Shak.
festive: Pertaining to, or becoming, a feast; festal; joyous; gay;mirthful; sportive.-- Fes"tive*ly, adv.The glad circle round them yield their souls To festive mirth and witthat knows no gall. Thomson.
festoon: A carved ornament consisting of flowers, and leaves, intermixedor twisted together, wound with a ribbon, and hanging or depending ina natural curve. See Illust. of Bucranium.
fetal: Pertaining to, or connected with, a fetus; as, fetalcirculation; fetal membranes.
fetch: To bring one's self; to make headway; to veer; as, to fetchabout; to fetch to windward. Totten. To fetch away (Naut.), to breakloose; to roll slide to leeward.-- To fetch and carry, to serve obsequiously, like a trainedspaniel.
fetcher: One wo fetches or brings.
fete: A feat. [Obs.] Chaucer.
feticide: The act of killing the fetus in the womb; the offense ofprocuring an abortion.
fetid: Having an offensive smell; stinking.Most putrefactions . . . smell either fetid or moldy. Bacon.
fetidness: The quality or state of being fetid.
fetlock: The cushionlike projection, bearing a tuft of long hair, on theback side of the leg above the hoof of the horse and similar animals.Also, the joint of the limb at this point (between the great pasternbone and the metacarpus), or the tuft of hair.Their wounded steeds Fret fetlock deep in gore. Shak.
fetter: 1. To put fetters upon; to shakle or confine the feet of with achain; to bind.My heels are fettered, but my fist is free. Milton.
fettle: 1. To repair; to prepare; to put in order. [Prov. Eng.]Carlyle.
fetus: The young or embryo of an animal in the womb, or in the egg;often restricted to the later stages in the development of viviparousand oviparous animals, embryo being applied to the earlier stages.[Written also foetus.]
feud: A stipendiary estate in land, held of superior, by service; theright which a vassal or tenant had to the lands or other immovablething of his lord, to use the same and take the profists thereofhereditarily, rendering to his superior such duties and services asbelong to military tenure, etc., the property of the soil alwaysremaining in the lord or superior; a fief; a fee.
feudalism: The feudal system; a system by which the holding of estates inland is made dependent upon an obligation to render military serviceto the kind or feudal superior; feudal principles and usages.
feudalist: An upholder of feudalism.
feudalization: The act of reducing to feudal tenure.
feudalize: To reduce toa feudal tenure; to conform to feudalism.
feudally: In a feudal manner.
feudatory: A tenant or vassal who held his lands of a superior oncondition of feudal service; the tenant of a feud or fief.The grantee . . . was styled the feudatory or vassal. Blackstone.[He] had for feudatories great princes. J. H. Newman.
fever: A diseased state of the system, marked by increased heat,acceleration of the pulse, and a general derangement of thefunctions, including usually, thirst and loss of appetite. Manydiseases, of which fever is the most prominent symptom, aredenominated fevers; as, typhoid fever; yellow fever.
few: Not many; small, limited, or confined in number; -- indicatinga small portion of units or individuals constituing a whole; often,by ellipsis of a noun, a few people. "Are not my days few" Job x. 20.Few know and fewer care. Proverb.
fey: Fated; doomed. [Old Eng. & Scot.]
fez: A felt or cloth cap, usually red and having a tassel, -- avariety of the tarboosh. See Tarboosh. B. Taylor.
fiance: To betroth; to affiance. [Obs.] Harmar.
fiancee: A betrothed woman.
fiasco: A complete or ridiculous failure, esp. of a musicalperformance, or of any pretentious undertaking.
fib: A falsehood; a lie; -- used euphemistically.They are very serious; they don't tell fibs. H. James.
fibber: One who tells fibs.
fibril: A small fiber; the branch of a fiber; a very slender thread; afibrilla. Cheyne.
fibrillation: The state of being reduced to fibers. Carpenter.
fibrinogen: An albuminous substance existing in the blood, and in otheranimal fluids, which either alone or with fibrinoplastin orparaglobulin forms fibrin, and thus causes coagulation.
fibroid: Resembling or forming fibrous tissue; made up of fibers; as,fibroid tumors.-- n.
fibroma: A tumor consisting mainly of fibrous tissue, or of samemodification of such tissue.
fibrous: Containing, or consisting of, fibers; as, the fibrous coat ofthe cocoanut; the fibrous roots of grasses.-- Fi"brous*ness, n.
fibrovascular: Containing woody fiber and ducts, as the stems of all floweringplants and ferns; -- opposed to cellular.
fibula: The outer and usually the smaller of the two bones of the leg,or hind limb, below the knee.
fiche: See FitchÉ.
fichu: A light cape, usually of lace, worn by women, to cover the neckand throat, and extending to the shoulders.
fickle: Not fixed or firm; liable to change; unstable; of a changeablemind; not firm in opinion or purpose; inconstant; capricious; as,Fortune's fickle wheel. Shak.They know how fickle common lovers are. Dryden.
fickleness: The quality of being fickle; instability; inconsonancy. Shak.
fickly: In a fickle manner. [Obs.] Pepys.
fiction: An assumption of a possible thing as a fact, irrespective ofthe question of its truth. Wharton.
fictional: Pertaining to, or characterized by, fiction; fictitious;romantic."Fictional rather than historical." Latham.
fictitious: Feigned; imaginary; not real; fabulous; counterfeit; false; notgenuine; as, fictitious fame.The human persons are as fictitious as the airy ones. Pope.-- Fic*ti"tious*ly, adv.-- Fic*ti"tious*ness, n.
fictive: Feigned; counterfeit. "The fount of fictive tears." Tennyson.
ficus: A genus of trees or shrubs, one species of which (F. Carica)produces the figs of commerce; the fig tree.
fiddle: A stringed instrument of music played with a bow; a violin; akit.
fiddler: A burrowing crab of the genus Gelasimus, of many species. Themale has one claw very much enlarged, and often holds it in aposition similar to that in which a musician holds a fiddle, hencethe name; -- called also calling crab, soldier crab, and fightingcrab.
fiddlestick: The bow, strung with horsehair, used in playing the fiddle; afiddle bow.
fidelity: Faithfulness; adherence to right; careful and exact observanceof duty, or discharge of obligations. Especially:(a) Adherence to a person or party to which one is bound; loyalty.Whose courageous fidelity was proof to all danger. Macaulay.The best security for the fidelity of men is to make interestcoincide with duty. A. Hamilton.
fidget: To move uneasily one way and the other; to move irregularly, orby fits and starts. Moore.
fidgetiness: Quality of being fidgety.
fidgety: Restless; uneasy. Lowell.
fiduciary: One who depends for salvation on faith, without works; anAntinomian. Hammond.
fie: An exclamation denoting contempt or dislike. See Fy. Fuller.
fief: An estate held of a superior on condition of military service;a fee; a feud. See under Benefice, n., 2.
field: The whole surface of an escutcheon; also, so much of it isshown unconcealed by the different bearings upon it. See Illust. ofFess, where the field is represented as gules (red), while the fessis argent (silver).
fielder: A ball payer who stands out in the field to catch or stopballs.
fielding: The act of playing as a fielder.
fieldwork: Any temporary fortification thrown up by an army in the field;-- commonly in the plural.All works which do not come under the head of permanent fortificationare called fieldworks. Wilhelm.
fiend: An implacable or malicious foe; one who is diabolically wickedor cruel; an infernal being; -- applied specifically to the devil ora demon.Into this wild abyss the wary fiend Stood on the brink of Hell andlooked a while. Milton.O woman! woman! when to ill thy mind Is bent, all hell contains nofouler fiend. Pope.
fiendish: Like a fiend; diabolically wicked or cruel; infernal;malignant; devilish; hellish.-- Fiend"ish*ly, adv.-- Fiend"ish*ness, n.
fieriness: The quality of being fiery; heat; acrimony; irritability; as, afieriness of temper. Addison.
fiesta: Among Spanish, a religious festival; a saint's day or holiday;also, a holiday or festivity.
fife: A small shrill pipe, resembling the piccolo flute, used chieflyto accompany the drum in military music. Fife major (Mil.), anoncommissioned officer who superintends the fifers of a regiment.-- Fife rail. (Naut.) (a) A rail about the mast, at the deck, tohold belaying pins, etc. (b) A railing around the break of a poopdeck.
fifer: One who plays on a fife.
fifteen: Five and ten; one more than fourteen.
fifth: The interval of three tones and a semitone, embracing fivediatonic degrees of the scale; the dominant of any key.
fifthly: In the fifth place; as the fifth in order.
fiftieth: One of fifty equal parts; the quotient of a unit divided byfifty.
fifty: Five times ten; as, fifty men.
fig: A small fruit tree (Ficus Carica) with large leaves, known fromthe remotest antiquity. It was probably native from Syria westward tothe Canary Islands.
figaro: An adroi
fighter: One who fights; a combatant; a warrior. Shak.
figment: An invention; a fiction; something feigned or imagined.Social figments, feints, and formalism. Mrs. Browning.It carried rather an appearance of figment and invention . . . thanof truth and reality. Woodward.
figuration: Mixture of concords and discords.
figure: A diagram or drawing; made to represent a magnitude or therelation of two or more magnitudes; a surface or space inclosed onall sides; -- called superficial when inclosed by lines, and solidwhen inclosed by surface; any arrangement made up of points, lines,angles, surfaces, etc.
figurehead: The figure, statue, or bust, on the prow of a ship.
figurine: A very small figure, whether human or of an animal; especially,one in terra cotta or the like; -- distinguished from statuette,which is applied to small figures in bronze, marble, etc.
fijian: Of or pertaining to the Fiji islands or their inhabitants.-- n.
filament: A thread or threadlike object or appendage; a fiber; esp.(Bot.), the threadlike part of the stamen supporting the anther.
filamentary: Having the character of, or formed by, a filament.
filamentous: Like a thread; consisting of threads or filaments. Gray.
filaria: A genus of slender, nematode worms of many species, parasiticin various animals. See Guinea worm.
filarial: Of, pertaining to, or caused by, filariæ and allied parasiticworms.
filbert: The fruit of the Corylus Avellana or hazel. It is an oval nut,containing a kernel that has a mild, farinaceous, oily taste,agreeable to the palate.
filch: To steal or take privily (commonly, that which is of littlevalue); to pilfer.Fain would they filch that little food away. Dryden.But he that filches from me my good name, Robs me of that which notenriches him, And makes me poor indeed. Shak.
filcher: One who filches; a thief.
file: To put upon the files or among the records of a court; to noteon (a paper) the fact date of its reception in court.To file a paper, on the part of a party, is to place it in theofficial custody of the clerk. To file, on the part of the clerk, isto indorse upon the paper the date of its reception, and retain it inhis office, subject to inspection by whomsoever it may concern.Burrill.
filer: One who works with a file.
filially: In a filial manner.
filibuster: A lawless military adventurer, especially one in quest ofplunder; a freebooter; -- originally applied to buccaneers infestingthe Spanish American coasts, but introduced into common English todesignate the followers of Lopez in his expedition to Cuba in 1851,and those of Walker in his expedition to Nicaragua, in 1855.
filigree: Ornamental work, formerly with grains or breads, but nowcomposed of fine wire and used chiefly in decorating gold and silverto which the wire is soldered, being arranged in designs frequentlyof a delicate and intricate arabesque pattern.
filigreed: Adorned with filigree. Tatler.
filing: A fragment or particle rubbed off by the act of filing; as,iron filings.
filipino: A native of the Philippine Islands, specif. one of Spanishdescent or of mixed blood.
fill: One of the thills or shafts of a carriage. Mortimer. Fillhorse, a thill horse. Shak.
filler: One who, or that which, fills; something used for filling.'T is mere filer, to stop a vacancy in the hexameter. Dryden.They have six diggers to four fillers, so as to keep the fillersalways at work. Mortimer.
fillet: A piece of lean meat without bone; sometimes, a long striprolled together and tied.
filling: Prepared wort added to ale to cleanse it. Back filling. (Arch.)See under Back, a.
filly: A female foal or colt; a young mare. Cf. Colt, Foal.Neighing in likeness of a filly foal. Shak.
film: To cover with a thin skin or pellicle.It will but skin and film the ulcerous place. Shak.
filminess: State of being filmy.
filmy: Composed of film or films.Whose filmy cord should bind the struggling fly. Dryden.
fils: Son; -- sometimes used after a French proper name todistinguish a son from his father, as, Alexandre Dumas, fils.
filter: Any porous substance, as cloth, paper, sand, or charcoal,through which water or other liquid may passed to cleanse it from thesolid or impure matter held in suspension; a chamber or devicecontaining such substance; a strainer; also, a similar device forpurifying air. Filter bed, a pond, the bottom of which is a filtercomposed of sand gravel.-- Filter gallery, an underground gallery or tunnel, alongside of astream, to collect the water that filters through the interveningsand and gravel; -- called also infiltration gallery.
filthily: In a filthy manner; foully.
filthy: Defiled with filth, whether material or moral; nasty; dirty;polluted; foul; impure; obscene. "In the filthy-mantled pool." Shak.He which is filthy let him be filthy still. Rev. xxii. 11.
filtrate: To filter; to defecate; as liquid, by straining or percolation.Arbuthnot.
filtration: The act or process of filtering; the mechanical separation of aliquid from the undissolved particles floating in it.
fin: To carve or cut up, as a chub.
finale: Close; termination; as:(a) (Mus.) The last movement of a symphony, sonata, concerto, or anyinstrumental composition.(b) The last composition performed in any act of an opera.(c) The closing part, piece, or scene in any public performance orexhibition.
finalist: Any of the players who meet in the final round of a tournamentin which the losers in any round do not play again.
financial: Pertaining to finance. "Our financial and commercial system."Macaulay.
financially: In a dfinancial manner. Burke.
financier: To conduct financial operations.
finch: A small singing bird of many genera and species, belonging tothe family Fringillidæ.
find: To determine an issue of fact, and to declare such adetermination to a court; as, the jury find for the plaintiff.Burrill.
findable: Capable of beong found; discoverable. Fuller.
finder: One who, or that which, finds; specifically (Astron.), a smalltelescope of low power and large field of view, attached to a largertelescope, for the purpose of finding an object more readily.
finding: The result of a judicial examination or inquiry, especiallyinto some matter of fact; a verdict; as, the finding of a jury.Burrill.After his friends finding and his rent. Chaucer.
fine: To impose a pecuniary penalty upon for an offense or breach oflaw; to set a fine on by judgment of a court; to punish by fine; tomulct; as, the trespassers were fined ten dollars.
finely: In a fine or finished manner.
finery: A charcoal hearth or furnace for the conversion of cast ironinto wrought iron, or into iron suitable for puddling.
finespun: Spun so as to be fine; drawn to a fine thread; attenuated;hence, unsubstantial; visionary; as, finespun theories.
finesse: The act of finessing. See Finesse, v. i., 2.
finger: To use the fingers in playing on an instrument. Busby.
fingerling: A young salmon. See Parr.
finial: The knot or bunch of foliage, or foliated ornament, that formsthe upper extremity of a pinnacle in Gothic architecture; sometimes,the pinnacle itself.
finical: Affectedly fine; overnice; unduly particular; fastidious."Finical taste." Wordsworth.The gross style consists in giving no detail, the finical in givingnothing else. Hazlitt.
finis: An end; conclusion. It is often placed at the end of a book.
finish: The joiner work and other finer work required for thecompletion of a building, especially of the interior. See Insidefinish, and Outside finish.
finished: Polished to the highest degree of excellence; complete;perfect; as, a finished poem; a finished education. Finished work(Mach.), work that is made smooth or polished, though not necessarilycompleted.
finite: Having a limit; limited in quantity, degree, or capacity;bounded; -- opposed to infinite; as, finite number; finite existence;a finite being; a finite mind; finite duration.
finitely: In a finite manner or degree.
finiteness: The state of being finite.
finitude: Limitation. Cheyne.
finlander: A native or inhabitant of Finland.
finn: A native of Finland; one of the FinnFinns.
finned: Having a fin, or fins, or anything resembling a fin. Mortimer.
finnic: Of or pertaining to the Finns.
finnish: Of or pertaining to Finland, to the Finns, or to theirlanguage.-- n.
finny: Having, or abounding in, fins, as fishes; pertaining to fishes.
fiord: A narrow inlet of the sea, penetrating between high banks orrocks, as on the coasts of Norway and Alaska. [Written also fjord.]
fir: A genus (Abies) of coniferous trees, often of large size andelegant shape, some of them valued for their timber and others fortheir resin. The species are distinguished as the balsam fir, thesilver fir, the red fir, etc. The Scoth fir is a Pinus.
fire: To cauterize. To fire up, to light up the fires of, as of anengine.
firearm: A gun, pistol, or any weapon from a shot is discharged by theforce of an explosive substance, as gunpowder.
firecracker: See Cracker., n., 3.
firedog: A support for wood in a fireplace; an andiron.
firefly: Any luminous winged insect, esp. luminous beetles of the familyLampyridæ.
fireless: Destitute of fire.
fireplace: The part a chimney appropriated to the fire; a hearth; --usually an open recess in a wall, in which a fire may be built.
fireproof: Proof against fire; incombustible.
firer: One who fires or sets fire to anything; an incendiary. [R.] R.Carew.
fireside: A place near the fire or hearth; home; domestic life orretirement.
firewood: Wood for fuel.
firework: A pyrotechnic exhibition. [Obs. in the sing.]Night before last, the Duke of Richmond gave a firework. Walpole.
firm: The name, title, or style, under which a company transactsbusiness; a partnership of two or more persons; a commercial house;as, the firm of Hope & Co.
firmament: The orb of the fixed stars; the most rmote of the celestialspheres.
firmamental: Pertaining to the firmament; celestial; being of the upperregions. Dryden.
firmly: In a firm manner.
firmness: The state or quality of being firm.
first: Before any other person or thing in time, space, rank, etc.; --much used in composition with adjectives and participles.Adam was first formed, then Eve. 1 Tim. ii. 13.At first, At the first, at the beginning or origin.-- First or last, at one time or another; at the beginning or end.And all are fools and lovers first or last. Dryden.
firstborn: First brought forth; first in the order of nativity; eldest;hence, most excellent; most distinguished or exalted.
firstling: Firstborn.All the firstling males. Deut. xv. 19.
firstly: In the first place; before anything else; -- sometimesimproperly used for first.
firth: An arm of the sea; a frith.
fiscal: Pertaining to the public treasury or revenue.The fiscal arreangements of government. A. Hamilton.
fish: A counter, used in various games.
fisher: A carnivorous animal of the Weasel family (Mustela Canadensis);the pekan; the "black cat."
fisherman: A ship or vessel employed in the business of taking fish, as inthe cod fishery.
fishery: The right to take fish at a certain place, or in particularwaters. Abbott.
fishhook: A hook with a pendant, to the end of which the fish-tackle ishooked. Dana.
fishiness: The state or quality of being fishy or fishlike. Pennant.
fishing: Pertaining to fishing; used in fishery; engaged in fishing; as,fishing boat; fishing tackle; fishing village. Fishing fly, anartificial fly for fishing.-- Fishing line, a line used in catching fish.-- Fishing net, a net of various kinds for catching fish; includingthe bag net, casting net, drag net, landing net, seine, shrimpingnet, trawl, etc.-- Fishing rod, a long slender rod, to which is attached the linefor angling.-- Fishing smack, a sloop or other small vessel used in sea fishing.-- Fishing tackle, apparatus used in fishing, as hook, line, rod,etc.-- Fishing tube (Micros.), a glass tube for selecting a microscopicobject in a fluid.
fishwife: A fishwoman.
fissile: Capable of being split, cleft, or divided in the direction ofthe grain, like wood, or along natural planes of cleavage, likecrystals.This crystal is a pellucid, fissile stone. Sir I. Newton.
fissility: Quality of being fissile.
fission: A method of asexual reproduction among the lowest (unicellular)organisms by means of a process of self-division, consisting ofgradual division or cleavage of the into two parts, each of whichthen becomes a separate and independent organisms; as when a cell inan animal or plant, or its germ, undergoes a spontaneous division,and the parts again subdivide. See Segmentation, and Cell division,under Division.
fissure: A narrow opening, made by the parting of any substance; acleft; as, the fissure of a rock. Cerebral fissures (Anat.), thefurrows or clefts by which the surface of the cerebrum is divided;esp., the furrows first formed by the infolding of the whole wall ofthe cerebrum.-- Fissure needle (Surg.), a spiral needle for catching together thegaping lips of wounds. Knight.-- Fissure of rolando (Anat.), the furrow separating the frontalfrom the parietal lobe in the cerebrum.-- Fissure of Sylvius (Anat.), a deep cerebral fissure separatingthe frontal from the temporal lobe. See Illust. under Brain.-- Fissure vein (Mining), a crack in the earth's surface filled withmineral matter. Raymond.
fist: the index mark [], used to direct special attention to thepassage which follows. Hand over fist (Naut.), rapidly; hand overhand.
fisticuff: A cuff or blow with the fist or hand; (pl.)
fistula: A permanent abnormal opening into the soft parts with aconstant discharge; a deep, narrow, chronic abscess; an abnormalopening between an internal cavity and another cavity or the surface;as, a salivary fistula; an anal fistula; a recto-vaginal fistula.Incomplete fistula (Med.), a fistula open at one end only.
fit: imp. & p. p. of Fight. [Obs. or Colloq.]
fitful: Full of fits; irregularly variable; impulsive and unstable.After life's fitful fever, he sleeps well. Shak.-- Fit"ful*ly, adv.-- Fit"ful*ness, n.The victorius trumpet peal Dies fitfully away. Macaulay.
fitly: In a fit manner; suitably; properly; conveniently; as, a maximfitly applied.
fitness: The state or quality of being fit; as, the fitness of measuresor laws; a person's fitness for office.
fitter: A little piece; a flitter; a flinder. [Obs.]Where's the Frenchman Alas, he's all fitters. Beau. & Fl.
fitting: Anything used in fitting up; especially (pl.),
five: Four and one added; one more than four.
fix: Fixed; solidified. [Obs.] Chaucer.
fixable: Capable of being fixed.
fixative: That which serves to set or fix colors or drawings, as amordant.
fixed: Stable; non-volatile. Fixed air (Old Chem.), carbonic acid orcarbon dioxide; -- so called by Dr. Black because it can be absorbedor fixed by strong bases. See Carbonic acid, under Carbonic.-- Fixed alkali (Old Chem.), a non-volatile base, as soda, orpotash, in distinction from the volatile alkali ammonia.-- Fixed ammunition (Mil.), a projectile and powder inclosedtogether in a case ready for loading.-- Fixed battery (Mil.), a battery which contains heavy guns andmortars intended to remain stationary; -- distinguished from movablebattery.-- Fixed bodies, those which can not be volatilized or separated bya common menstruum, without great difficulty, as gold, platinum,lime, etc.-- Fixed capital. See the Note under Capital, n., 4.-- Fixed fact, a well established fact. [Colloq.] -- Fixed light,one which emits constant beams; -- distinguished from a flashing,revolving, or intermittent light.-- Fixed oils (Chem.), non-volatile, oily substances, as stearineand olein, which leave a permanent greasy stain, and which can not bedistilled unchanged; -- distinguished from volatile or essentialoils.-- Fixed pivot (Mil.), the fixed point about which any line oftroops wheels.-- Fixed stars (Astron.), such stars as always retain nearly thesame apparent position and distance with respect to each other, thusdistinguished from planets and comets.
fixedly: In a fixed, stable, or constant manner.
fixture: Anything of an accessory character annexed to houses and lands,so as to constitute a part of them. This term is, however, quitefrequently used in the peculiar sense of personal chattels annexed tolands and tenements, but removable by the person annexing them, orhis personal representatives. In this latter sense, the same thingsmay be fixtures under some circumstances, and not fixtures underothers. Wharton (Law Dict. ). Bouvier.
fizz: To make a hissing sound, as a burning fuse.
fizzle: A failure or abortive effort. [Colloq.]
fjord: See Fiord.
flabbergast: To astonish; to strike with wonder, esp. by extraordinarystatements. [Jocular] Beaconsfield.
flabbily: In a flabby manner.
flabbiness: Quality or state of being flabby.
flabby: Yielding to the touch, and easily moved or shaken; hangingloose by its own weight; wanting firmness; flaccid; as, flabby flesh.
flaccid: Yielding to pressure for want of firmness and stiffness; softand weak; limber; lax; drooping; flabby; as, a flaccid muscle;flaccid flesh.Religious profession . . . has become flacced. I. Taylor.-- Flac"cid*ly, adv.-- Flac"cid*ness, n.
flaccidity: The state of being flaccid.
flacon: A small glass bottle; as, a flacon for perfume. "Two glassflacons for the ink." Longfellow.
flag: An aquatic plant, with long, ensiform leaves, belonging toeither of the genera Iris and Acorus. Cooper's flag, the cat-tail(Typha latifolia), the long leaves of which are placed between thestaves of barrels to make the latter water-tight.-- Corn flag. See under 2d Corn.-- Flag broom, a coarse of broom, originally made of flags orrushes.-- Flag root, the root of the sweet flag.-- Sweet flag. See Calamus, n., 2.
flagellate: To whip; to scourge; to flog.
flagellation: A beating or flogging; a whipping; a scourging. Garth.
flagellator: One who practices flagellation; one who whips or scourges.
flagellum: A young, flexible shoot of a plant; esp., the long trailingbranch of a vine, or a slender branch in certain mosses.
flageolet: A small wooden pipe, having six or more holes, and a mouthpieceinserted at one end. It produces a shrill sound, softer than of thepiccolo flute, and is said to have superseded the old recorder.Flageolet tones (Mus.), the naturel harmonics or overtones ofstringed instruments.
flagging: A pavement or sidewalk of flagstones; flagstones, collectively.
flagon: A vessel with a narrow mouth, used for holding and conveyingliquors. It is generally larger than a bottle, and of leather orstoneware rather than of glass.A trencher of mutton chops, and a flagon of ale. Macaulay.
flagrance: Flagrancy. Bp. Hall.
flagrantly: In a flagrant manner.
flagship: The vessel which carries the commanding officer of a fleet orsquadron and flies his distinctive flag or pennant.
flagstaff: A staff on which a flag is hoisted.
flagstone: A flat stone used in paving, or any rock which will split intosuch stones. See Flag, a stone.
flake: A small stage hung over a vessel's side, for workmen to standon in calking, etc.
flakiness: The state of being flaky.
flaky: Consisting of flakes or of small, loose masses; lying, orcleaving off, in flakes or layers; flakelike.What showers of mortal hail, what flaky fires! Watts.A flaky weight of winter's purest snows. Wordsworth.
flambe: Decorated by glaze splashed or irregularly spread upon thesurface, or apparently applied at the top and allowed to run down thesides; -- said of pieces of Chinese porcelain.
flambeau: A flaming torch, esp. one made by combining together a numberof thick wicks invested with a quick-burning substance (anciently,perhaps, wax; in modern times, pitch or the like); hence, any torch.
flamboyant: Characterized by waving or flamelike curves, as in the traceryof windows, etc.; -- said of the later (15th century) French Gothicstyle.
flame: To kindle; to inflame; to excite.And flamed with zeal of vengeance inwardly. Spenser.
flamingo: Any bird of the genus Phoenicopterus. The flamingoes havewebbed feet, very long legs, and a beak bent down as if broken. Theircolor is usually red or pink. The American flamingo is P. ruber; theEuropean is P. antiquorum.
flammability: The quality of being flammable; inflammability. [Obs.] Sir T.Browne.
flammable: Inflammable. [Obs.]
flange: To make a flange on; to furnish with a flange.
flank: That part of a bastion which reaches from the curtain to theface, and defends the curtain, the flank and face of the oppositebastion; any part of a work defending another by a fire along theoutside of its parapet. See Illust. of Bastion.
flanker: One who, or that which, flanks, as a skirmisher or a body oftroops sent out upon the flanks of an army toguard a line of march,or a fort projecting so as to command the side of an assailing body.They threw out flankers, and endeavored to dislodge their assailants.W. Irwing.
flannel: A soft, nappy, woolen cloth, of loose texture. Shak. Adam'sflannel. (Bot.) See under Adam.-- Canton flannel, Cotton flannel. See Cotton flannel, under Cotton.
flap: Anything broad and limber that hangs loose, or that is attachedby one side or end and is easily moved; as, the flap of a garment.A cartilaginous flap upon the opening of the larynx. Sir T. Browne.
flare: Leaf of lard. "Pig's flare." Dunglison.
flash: To cover with a thin layer, as objects of glass with glass of adifferent color. See Flashing, n., 3 (b).
flashily: In a flashy manner; with empty show.
flashiness: The quality of being flashy.
flashing: The creation of an artifical flood by the sudden letting in ofa body of water; -- called also flushing.
flask: The wooden or iron frame which holds the sand, etc., formingthe mold used in a foundry; it consists of two or more parts; viz.,the cope or top; sometimes, the cheeks, or middle part; and the drag,or bottom part. When there are one or more cheeks, the flask iscalled a three part flask, four part flask, etc. Erlenmeyer flask, athin glass flask, flat-bottomed and cone-shaped to allow of safelyshaking its contents laterally without danger of spilling; -- socalled from Erlenmeyer, a German chemist who invented it.-- Florence flask. Etym: [From Florence in Italy.] (a) Same asBetty, n., 3. (b) A glass flask, round or pear-shaped, with round orflat bottom, and usually very thin to allow of heating solutions.-- Pocket flask, a kind of pocket dram bottle, often covered withmetal or leather to protect it from breaking.
flat: Wanting relief; destitute of variety; without points ofprominence and striking interest.A large part of the work is, to me, very flat. Coleridge.
flatboat: A boat with a flat bottom and square ends; -- used for thetransportation of bulky freight, especially in shallow waters.
flatfish: Any fish of the family Pleuronectidæ; esp., the winter flounder(Pleuronectes Americanus). The flatfishes have the body flattened,swim on the side, and have eyes on one side, as the flounder, turbot,and halibut. See Flounder.
flathead: Characterized by flatness of head, especially that produced byartificial means, as a certain tribe of American Indians.
flatiron: An iron with a flat, smooth surface for ironing clothes.
flatly: In a flat manner; evenly; horizontally; without spirit; dully;frigidly; peremptori;y; positively, plainly. "He flatly refused hisaid." Sir P. Sidney.He that does the works of religion slowly, flatly, and withoutappetite. Jer. Taylor.
flatten: To lower the pitch of; to cause to sound less sharp; to letfall from the pitch. To flatten a sail (Naut.), to set it more nearlyfore-and-aft of the vessel.-- Flattening oven, in glass making, a heated chamber in which splitglass cylinders are flattened for window glass.
flatter: To use flattery or insincere praise.If it may stand him more in stead to lie, Say and unsay, feign,flatter, or adjure. Milton.
flatterer: One who flatters.The most abject flaterers degenerate into the greatest tyrants.Addison.
flattering: That flatters (in the various senses of the verb); as, aflattering speech.Lay not that flattering unction to your soul. Shak.A flattering painter, who made it his care, To draw men as they oughtbe, not as they are. Goldsmith.
flatteringly: With flattery.
flattery: The act or practice of flattering; the act of pleasing byartiful commendation or compliments; adulation; false, insincere, orexcessive praise.Just praise is only a debt, but flattery is a present. Rambler.Flattery corrupts both the receiver and the giver. Burke.
flattish: Somewhat flat. Woodward.
flatulently: In a flatulent manner; with flatulence.
flatware: Articles for the table, as china or silverware, that are moreor less flat, as distinguished from hollow ware.
flatworm: Any worm belonging to the Plathelminthes; also, sometimesapplied to the planarians.
flaunt: To throw or spread out; to flutter; to move ostentatiously; as,a flaunting show.You flaunt about the streets in your new gilt chariot. Arbuthnot.One flaunts in rags, one flutters in brocade. Pope.
flauntingly: In a flaunting way.
flautist: A player on the flute; a flutist.
flavor: To give flavor to; to add something (as salt or a spice) to, togive character or zest.
flavored: Having a distinct flavor; as, high-flavored wine.
flavorless: Without flavor; tasteless.
flawless: Free from flaws. Boyle.
flax: A plant of the genus Linum, esp. the L. usitatissimum, whichhas a single, slender stalk, about a foot and a half high, with blueflowers. The fiber of the bark is used for making thread and cloth,called linen, cambric, lawn, lace, etc. Linseed oil is expressed fromthe seed.
flaxen: Made of flax; resembling flax or its fibers; of the color offlax; of a light soft straw color; fair and flowing, like flax ortow; as, flaxen thread; flaxen hair.
flay: To skin; to strip off the skin or surface of; as, to flay anox; to flay the green earth.With her nails She 'll flay thy wolfish visage. Shak.
flayer: One who strips off the skin.
flea: To flay. [Obs.]He will be fleaced first And horse collars made of's skin. J.Fletcher.
fleabane: One of various plants, supposed to have efficacy in drivingaway fleas. They belong, for the most part, to the genera Conyza,Erigeron, and Pulicaria.
fleck: A flake; also, a lock, as of wool. [Obs.] J. Martin.
fled: imp. & p. p. of Flee.
fledge: Feathered; furnished with feathers or wings; able to fly.Hfledge with wings. Milton.
fledgeling: A young bird just fledged.
flee: To run away, as from danger or evil; to avoid in an alarmed orcowardly manner; to hasten off; -- usually with from. This issometimes omitted, making the verb transitive.[He] cowardly fled, not having struck one stroke. Shak.Flee fornication. 1 Cor. vi. 18.So fled his enemies my warlike father. Shak.
fleece: The fine web of cotton or wool removed by the doffing knifefrom the cylinder of a carding machine. Fleece wool, wool shorn fromthe sheep.-- Golden fleece. See under Golden.
fleecer: One who fleeces or strips unjustly, especially by trickery orfraund. Prynne.
fleecy: Covered with, made of, or resembling, a fleece. "Fleecyflocks." Prior.
fleer: One who flees. Ld. Berners.
fleeringly: In a fleering manner.
fleet: To slip on the whelps or the barrel of a capstan or windlass; -- said of a cable or hawser.
fleeting: Passing swiftly away; not durable; transient; transitory; as,the fleeting hours or moments.
fleetingly: In a fleeting manner; swiftly.
fleetly: In a fleet manner; rapidly.
fleetness: Swiftness; rapidity; velocity; celerity; speed; as, thefleetness of a horse or of time.
fleming: A native or inhabitant of Flanders.
flemish: Pertaining to Flanders, or the Flemings.-- n.
flesh: To remove flesh, membrance, etc., from, as from hides.
fleshiness: The state of being fleshy; plumpness; corpulence; grossness.Milton.
fleshliness: The state of being fleshly; carnal passions and appetites.Spenser.
fleshly: In a fleshly manner; carnally; lasciviously. [Obs.] Chaucer.
fleshpot: A pot or vessel in which flesh is cooked; hence (pl.),
fleshy: Composed of firm pulp; succulent; as, the houseleek, cactus,and agave are fleshy plants.
fletcher: One who fletches of feathers arrows; a manufacturer of bows andarrows. [Obs.] Mortimer.
flew: imp. of Fly.
flex: To bend; as, to flex the arm.
flexibility: The state or quality of being flexible; flexibleness; pliancy;pliability; as, the flexibility of strips of hemlock, hickory,whalebone or metal, or of rays of light. Sir I. Newton.All the flexibility of a veteran courtier. Macaulay.
flexor: A muscle which bends or flexes any part; as, the flexors of thearm or the hand; -- opposed to extensor.
flexure: The last joint, or bend, of the wing of a bird.
flibbertigibbet: An imp. Shak.
flick: To whip lightly or with a quick jerk; to flap; as, to flick ahorse; to flick the dirt from boots. Thackeray.
flicker: The golden-winged woodpecker (Colaptes aurutus); -- so calledfrom its spring note. Called also yellow-hammer, high-holder, pigeonwoodpecker, and yucca.The cackle of the flicker among the oaks. Thoureau.
flickeringly: In a flickering manner.
flier: A fly. See Fly, n., 9, and 13 (b).
flightily: In a flighty manner.
flightiness: The state or quality of being flighty.The flightness of her temper. Hawthorne.
flimflam: A freak; a trick; a lie. Beau. & Fl.
flimsily: In a flimsy manner.
flimsiness: The state or quality of being flimsy.
flimsy: Weak; feeble; limp; slight; vain; without strength or solidity;of loose and unsubstantial structure; without reason or plausibility;as, a flimsy argument, excuse, objection.Proud of a vast extent of flimsy lines. Pope.All the flimsy furniture of a country miss's brain. Sheridan.
flinch: To let the foot slip from a ball, when attempting to give atight croquet.
flincher: One who flinches or fails.
flinger: One who flings; one who jeers.
flint: A massive, somewhat impure variety of quartz, in color usuallyof a gray to brown or nearly black, breaking with a conchoidalfracture and sharp edge. It is very hard, and strikes fire withsteel.
flintiness: The state or quality of being flinty; hardness; cruelty. Beau.& Fl.
flinty: Consisting of, composed of, abounding in, or resembling, flint;as, a flinty rock; flinty ground; a flinty heart. Flinty rockFlintystate, a siliceous slate; -- basanite is here included. See Basanite.
flip: A mixture of beer, spirit, etc., stirred and heated by a hotiron. Flip dog, an iron used, when heated, to warm flip.
flippancy: The state or quality of being flippant.This flippancy of language. Bp. Hurd.
flippant: A flippant person. [R.] Tennyson.
flippantly: In a flippant manner.
flipper: A broad flat limb used for swimming, as those of seals, seaturtles, whales, etc.
flirt: One who flirts; esp., a woman who acts with giddiness, or playsat courtship; a coquette; a pert girl.Several young flirts about town had a design to cast us out of thefashionable world. Addison.
flit: Nimble; quick; swift. [Obs.] See Fleet.
flitter: To flutter. [Obs.] Chaucer.
float: A contrivance for affording a copious stream of water to theheated surface of an object of large bulk, as an anvil or die.Knight.
floatable: That may be floated.
floating: Floating threads. See Floating threads, above.
flocculence: The state of being flocculent.
flocculent: Applied to the down of newly hatched or unfledged birds.
flock: To gather in companies or crowds.Friends daily flock. Dryden.Flocking fowl (Zoöl.), the greater scaup duck.
floe: A low, flat mass of floating ice. Floe rat (Zoöl.), a seal(Phoca foetida).
flog: To beat or strike with a rod or whip; to whip; to lash; tochastise with repeated blows.
flogging: from Flog, v. t. Flogging chisel (Mach.), a large cold chisel,used in chipping castings.-- Flogging hammer, a small sledge hammer used for striking aflogging chisel.
flooder: One who floods anything.
flooding: The filling or covering with water or other fluid; overflow;inundation; the filling anything to excess.
floor: That part of the bottom of a vessel on each side of the keelsonwhich is most nearly horizontal.
flooring: A platform; the bottom of a room; a floor; pavement. See Floor,n. Addison.
floorwalker: One who walks about in a large retail store as an overseer anddirector. [U.S.]
flop: Act of flopping. [Colloq.] W. H. Russell.
floppy: Having a tendency to flop or flap; as, a floppy hat brim. G.Eliot.
flora: The goddess of flowers and spring.
floral: Containing, or belonging to, a flower; as, a floral bud; afloral leaf; floral characters. Martyn. Floral envelope (Bot.), thecalyx and corolla, one or the other of which (mostly the corolla) maybe wanting.
florally: In a floral manner.
florentine: Belonging or relating to Florence, in Italy. Florentine mosaic,a mosaic of hard or semiprecious stones, often so chosen and arrangedthat their natural colors represent leaves, flowers, and the like,inlaid in a background, usually of black or white marble.
florescence: A bursting into flower; a blossoming. Martyn.
florescent: Expanding into flowers; blossoming.
floret: A little flower; one of the numerous little flowers whichcompose the head or anthodium in such flowers as the daisy, thistle,and dandelion. Gray.
florid: Flowery; ornamental; running in rapid melodic figures,divisions, or passages, as in variations; full of fioriture or littleornamentations.
floridity: The quality of being florid; floridness. Floyer.
floridly: In a florid manner.
floridness: The quality of being florid. Boyle.
florin: A silver coin of Florence, first struck in the twelfth century,and noted for its beauty. The name is given to different coins indifferent countries. The florin of England, first minted in 1849, isworth two shillings, or about 48 cents; the florin of theNetherlands, about 40 cents; of Austria, about 36 cents.
floss: The slender styles of the pistillate flowers of maize; alsocalled silk.
flossy: Pertaining to, made of, or resembling, floss; hence, light;downy.
flotilla: A little fleet, or a fleet of small vessels.
flounce: To throw the limbs and body one way and the other; to spring,turn, or twist with sudden effort or violence; to struggle, as ahorse in mire; to flounder; to throw one's self with a jerk or spasm,often as in displeasure.To flutter and flounce will do nothing but batter and bruise us.Barrow.With his broad fins and forky tail he laves The rising sirge, andflounces in the waves. Addison.
flounder: A flatfish of the family Pleuronectidæ, of many species.
flour: The finely ground meal of wheat, or of any other grain;especially, the finer part of meal separated by bolting; hence, thefine and soft powder of any substance; as, flour of emery; flour ofmustard. Flour bolt, in milling, a gauze-covered, revolving,cylindrical frame or reel, for sifting the flour from the refusecontained in the meal yielded by the stones.-- Flour box a tin box for scattering flour; a dredging box.-- Flour dredge or dredger, a flour box.-- Flour dresser, a mashine for sorting and distributing flouraccording to grades of fineness.-- Flour mill, a mill for grinding and sifting flour.
flourisher: One who flourishes.
floury: Of or resembling flour; mealy; covered with flour. Dickens.
flout: To mock or insult; to treat with contempt.Phillida flouts me. Walton.Three gaudy standarts lout the pale blue sky. Byron.
flouter: One who flouts; a mocker.
flow: imp. sing. of Fly, v. i. Chaucer.
flowage: An overflowing with water; also, the water which thusoverflows.
flower: That part of a plant destined to produce seed, and henceincluding one or both of the sexual organs; an organ or combinationof the organs of reproduction, whether inclosed by a circle of foliarparts or not. A complete flower consists of two essential parts, thestamens and the pistil, and two floral envelopes, the corolla andcallyx. In mosses the flowers consist of a few special leavessurrounding or subtending organs called archegonia. See Blossom, andCorolla.
floweriness: The state of being flowery.
flowering: Having conspicuous flowers; -- used as an epithet with manynames of plants; as, flowering ash; flowering dogwood; floweringalmond, etc. Flowering fern, a genus of showy ferns (Osmunda), withconspicuous bivalvular sporangia. They usually grow in wet places.-- Flowering plants, plants which have stamens and pistils, andproduce true seeds; phenogamous plants; -- distinguished fromflowerless plants.-- Flowering rush, a European rushlike plant (Butomus umbellatus),with an umbel of rosy blossoms.
flowerless: Having no flowers. Flowerless plants, plants which have no trueflowers, and produce no seeds; cryptigamous plants.
flowerpot: A vessel, commonly or earthenware, for earth in which plantsare grown.
flowing: That flows or for flowing (in various sense of the verb);gliding along smoothly; copious. Flowing battery (Elec.), a batterywhich is kept constant by the flowing of the exciting liquid throughthe cell or cells. Knight.-- Flowing furnace, a furnace from which molten metal, can be drawn,as through a tap hole; a foundry cupola.-- Flowing sheet (Naut.), a sheet when eased off, or loosened to thewind, as when the wind is abaft the beam. Totten.
flowingly: In a flowing manner.
flown: p. p. of Fly; -- often used with the auxiliary verb to be; as,the birds are flown.
fluctuant: showing undulation or fluctuation; as, a fluctuant tumor.
fluctuate: To cause to move as a wave; to put in motion. [R.]And fluctuate all the still perfume. Tennyson.
fluctuation: The motion or undulation of a fluid collected in a natural orartifical cavity, which is felt when it is subjected to pressure orpercussion. Dunglison.
flue: An inclosed passage way for establishing and directing acurrent of air, gases, etc.; an air passage; esp.:(a) A compartment or division of a chimney for conveying flame andsmoke to the outer air.(b) A passage way for conducting a current of fresh, foul, or heatedair from one place to another.(c) (Steam Boiler) A pipe or passage for conveying flame and hotgases through surrounding water in a boiler; -- distinguished from atube which holds water and is surrounded by fire. Small flues arecalled fire tubes or simply tubes. Flue boiler. See under Boiler.-- Flue bridge, the separating low wall between the flues and thelaboratory of a reverberatory furnace.-- Flue plate (Steam Boiler), a plate to which the ends of the fluesare fastened; -- called also flue sheet, tube sheet, and tube plate.-- Flue surface (Steam Boiler), the aggregate surface of fluesexposed to flame or the hot gases.
fluency: The quality of being fluent; smoothness; readiness ofutterance; volubility.The art of expressing with fluency and perspicuity. Macaulay.
fluent: A variable quantity, considered as increasing or diminishing; -- called, in the modern calculus, the function or integral.
fluently: In a fluent manner.
fluff: Nap or down; flue; soft, downy feathers.
fluffy: Pertaining to, or resembling, fluff or nap; soft and downy."The carpets were fluffy." Thackeray.The present Barnacle . . . had a youthful aspect, and the fluffiestlittle whisker, perhaps, that ever was seen. Dickens.-- Fluff"i*ness, n.
fluid: Having particles which easily move and change their relativeposition without a separation of the mass, and which easily yield topressure; capable of flowing; liquid or gaseous.
fluidity: The quality of being fluid or capable of flowing; a liquid,aëriform. or gaseous state; -- opposed to solidity.It was this want of organization, this looseness and fluidity of thenew movement, that made it penetrate through every class of society.J. R. Green.
fluidness: The state of being flluid; fluidity.
fluke: One of the lobes of a whale's tail, so called from theresemblance to the fluke of an anchor.
fluky: Formed like, or having, a fluke.
flume: A stream; especially, a passage channel, or conduit for thewater that drives a mill wheel; or an artifical channel of water forhydraulic or placer mining; also, a chute for conveying logs orlumber down a declivity.
flung: imp. & p. p. of Fling.
flunk: To fail, as on a lesson; to back out, as from an undertaking,through fear.
fluorescence: That property which some transparent bodies have of producingat their surface, or within their substance, light different in colorfrom the mass of the material, as when green crystals of fluor sparafford blue reflections. It is due not to the difference in the colorof a distinct surface layer, but to the power which the substance hasof modifying the light incident upon it. The light emitted byfluorescent substances is in general of lower refrangibility than theincident light. Stockes.
fluorescent: Having the property of fluorescence.
fluoride: A binary compound of fluorine with another element or radical.Calcium fluoride (Min.), fluorite, CaF2. See Fluorite.
fluorine: A non-metallic, gaseous element, strongly acid or negative, orassociated with chlorine, bromine, and iodine, in the halogen groupof which it is the first member. It always occurs combined, is veryactive chemically, and possesses such an avidity for most elements,and silicon especially, that it can neither be prepared nor kept inglass vessels. If set free it immediately attacks the containingmaterial, so that it was not isolated until 1886. It is a pungent,corrosive, colorless gas. Symbol F. Atomic weight 19.
fluorite: Calcium fluoride, a mineral of many different colors, white,yellow, purple, green, red, etc., often very beautiful, crystallizingcommonly in cubes with perfect octahedral cleavage; also massive. Itis used as a flux. Some varieties are used for ornamental vessels.Also called fluor spar, or simply fluor.
fluoroscope: An instrument for observing or exhibiting fluorescence.
fluoroscopy: Examination of an object, as the human body, by exposing it tothe X rays and observing the shadow cast upon a fluorescent screen;cryptoscopy.
flurry: To put in a state of agitation; to excite or alarm. H.Swinburne.
flush: A hand of cards of the same suit.
flushness: The state of being flush; abundance.
fluster: To make hot and rosy, as with drinking; to heat; hence, tothrow into agitation and confusion; to confuse; to muddle.His habit or flustering himself daily with claret. Macaulay.
flute: A channel of curved section; -- usually applied to one of avertical series of such channels used to decorate columns andpilasters in classical architecture. See Illust. under Base, n.
fluting: Decoration by means of flutes or channels; a flute, or flutescollectively; as, the fluting of a column or pilaster; the fluting ofa lady's ruffle. Fluting iron, a laundry iron for fluting ruffles; --called also Italian iron, or gaufering iron. Knight.-- Fluting lathe, a machine for forming spiral flutes, as onbalusters, table legs, etc.
flutist: A performer on the flute; a flautist. Busby.
fluty: Soft and clear in tone, like a flute.
fluvial: Belonging to rivers; growing or living in streams or ponds; as,a fluvial plant.
flux: Any substance or mixture used to promote the fusion of metalsor minerals, as alkalies, borax, lime, fluorite.
fly: That part of a compass on which the points are marked; thecompass card. Totten.
flyblown: Tainted or contaminated with flyblows; damaged; foul.Wherever flyblown reputations were assembled. Thackeray.
flycatcher: One of numerous species of birds that feed upon insects, whichthey take on the wing.
flyer: One in a flight of steps which are parallel to each other(as inordinary stairs), as distinguished from a winder.
flying: Moving in the air with, or as with, wings; moving lightly orrapidly; intended for rapid movement.
flyspeck: A speck or stain made by the excrement of a fly; hence, anyinsignificant dot.
foal: The young of any animal of the Horse family (Equidæ); a colt; afilly. Foal teeth (Zoöl.), the first set of teeth of a horse.-- In foal, With foal, being with young; pregnant; -- said of a mareor she ass.
foam: The white substance, consisting of an aggregation of bubbles,which is formed on the surface of liquids,or in the mouth of ananimal, by violent agitation or fermentation; froth; spume; scum; as,the foam of the sea. Foam cock, in steam boilers, a cock at the waterlevel, to blow off impurities.
foamy: Covered with foam; frothy; spumy.Behold how high the foamy billows ride! Dryden.
fob: A little pocket for a watch. Fob chain, a short watch chainworn a watch carried in the fob.
focal: Belonging to,or concerning, a focus; as, a focal point. Focaldistance, or length,of a lens or mirror (Opt.), the distance of thefocus from the surface of the lens or mirror, or more exactly, in thecase of a lens, from its optical center. --Focal distance of atelescope, the distance of the image of an object from the objectglass.
focus: A point in which the rays of light meet, after being reflectedor refrcted, and at which the image is formed; as, the focus of alens or mirror.
fodder: A weight by which lead and some other metals were formerlysold, in England, varying from 19 [Obs.]
foe: See Fiend, and cf. Feud a quarrel.
foeman: An enemy in war.And the stern joy which warriors feel In foemen worthy of theirsteel. Sir W. Scott
foetal: Same as Fetal.
foetus: Same as Fetus.
fog: (Agric.) To pasture cattle on the fog, or aftergrass, of; toeat off the fog from.
fogey: See Fogy.
foggily: In a foggy manner; obscurely. Johnson.
fogginess: The state of being foggy. Johnson.
fogy: A dull old fellow; a person behind the times, over-conservative, or slow; -- usually preceded by old. [Written alsofogie and fogey.] [Colloq.]Notorious old bore; regular old fogy. Thackeray.
foible: Weak; feeble. [Obs.] Lord Herbert.
foil: To defile; to soil. [Obs.]
foist: A light and fast-sailing ship. [Obs.] Beau. & Fl.
fold: To become folded, plaited, or doubled; to close over another ofthe same kind; to double together; as, the leaves of the door fold. 1Kings vi. 34.
folder: One who, or that which, folds; esp., a flat, knifelikeinstrument used for folding paper.
folderol: Nonsense. [Colloq.]
foliage: To adorn with foliage or the imitation of foliage; to form intothe representation of leaves. [R.] Drummond.
foliate: Furnished with leaves; leafy; as, a foliate stalk. Foliatecurve. (Geom.) Same as Folium.
foliated: Containing, or consisting of, foils; as, a foliated arch.
folio: The page number. The even folios are on the left-hand pages andthe odd folios on the right-hand.
follicle: A simple podlike pericarp which contains several seeds andopens along the inner or ventral suture, as in the peony, larkspurand milkweed.
follow: To go or come after; -- used in the various senses of thetransitive verb: To pursue; to attend; to accompany; to be a result;to imitate.
follower: 1. One who follows; a pursuer; an attendant; a disciple; adependent associate; a retainer.
following: (In the field of a telescope) In the direction from which starsare apparently moving (in consequence of the erth's rotation); as, asmall star, north following or south following. In the directiontoward which stars appear to move is called preceding.
fomalhaut: A star of the first magnitude, in the constellation PiscisAustralis, or Southern Fish.
fomenter: One who foments; one who encourages or instigates; as, afomenter of sedition.
fond: imp. of Find. Found. Chaucer.
fondant: A kind of soft sweetmeat made by boiling solutions to the pointof crystallization, usually molded; as, cherry fondant.
fondle: To treat or handle with tenderness or in a loving manner; tocaress; as, a nurse fondles a child.
fondu: Blended; passing into each other by subtle gradations; -- saidof colors or of the surface or material on which the colors are laid.
font: A complete assortment of printing type of one size, including adue proportion of all the letters in the alphabet, large and small,points, accents, and whatever else is necessary for printing withthat variety of types; a fount.
fontanel: An issue or artificial ulcer for the discharge of humors fromthe body.[Obs.] Wiseman.
fontanelle: Same as Fontanel, 2.
food: To supply with food. [Obs.] Baret.
fool: A compound of gooseberries scalded and crushed, with cream; --commonly called gooseberry fool.
foolhardily: In a foolhardy manner.
foolhardiness: Courage without sense or judgment; foolish rashness;recklessness. Dryden.
foolhardy: Daring without judgment; foolishly adventurous and bold.Howell.
foolishly: In a foolish manner.
foolscap: A writing paper made in sheets, ordinarily 16 x 13 inches, andfolded so as to make a page 13 x 8 inches. See Paper.
foot: The terminal part of the leg of man or an animal; esp., thepart below the ankle or wrist; that part of an animal upon which itrests when standing, or moves. See Manus, and Pes.
football: An inflated ball to be kicked in sport, usually made in Indiarubber, or a bladder incased in Leather. Waller.
footbridge: A narrow bridge for foot passengers only.
footfall: A setting down of the foot; a footstep; the sound of afootstep. Shak.Seraphim, whose footfalls tinkled on the tufted floor. Poe
foothill: A low hill at the foot of highe
foothold: A holding with the feet; firm L'Estrange.
footing: The thickened or sloping portion of a wall, or of an embankmentat its foot. Footing course (Arch.), one of the courses of masonry atthe foot of a wall, broader than the courses above.-- To pay one's footing, to pay a fee on first doing anything, asworking at a trade or in a shop. Wright.-- Footing beam, the tie beam of a roof.
footless: Having no feet.
footman: A moth of the family Lithosidæ; -- so called from its livery-like colors.
footnote: A note of reference or comment at the foot of a page.
footpad: A highwayman or robber on foot.
footpath: A narrow path or way for pedestrains only; a footway.
footprint: The impression of the foot; a trace or footmark; as,"Footprints of the Creator."
footstool: A low stool to support the feet of one when sitting.
fop: One whose ambition it is to gain admiration by showy dress; acoxcomb; an inferior dandy.
foppish: Foplike; characteristic of a top in dress or manners; making anostentatious display of gay clothing; affected in manners.
for: In the most general sense, indicating that in consideration of,in view of, or with reference to, which anything is done or takesplace.
forage: To wander or rove in search of food; to collect food, esp.forage, for horses and cattle by feeding on or stripping the country;to ravage; to feed on spoil.His most mighty father on a hill Stood smiling to behold his lion'swhelp Forage in blood of French nobility. Shak.Foraging ant (Zoöl.), one of several species of ants of the genusEciton, very abundant in tropical America, remarkable for marching invast armies in search of food.-- Foraging cap, a forage cap.-- Foraging party, a party sent out after forage.
forager: One who forages.
foray: A sudden or irregular incursion in border warfare; hence, anyirregular incursion for war or spoils; a raid. Spenser.The huge Earl Doorm, . . . Bound on a foray, rolling eyes of prey.Tennyson.
forayer: One who makes or joins in a foray.They might not choose the lowand road, For the Merse forayers wereabroad. Sir W. Scott.
forbade: imp. of Forbid.
forbear: An ancestor; a forefather; -- usually in the plural. [Scot.]"Your forbears of old." Sir W. Scott.
forbearance: The act of forbearing or waiting; the exercise of patience.He soon shall findForbearance no acquittance ere day end. Milton.
forbearer: One who forbears. Tusser.
forbid: To utter a prohibition; to prevent; to hinder. "I did not orforbid." Milton.
forbiddance: The act of forbidding; prohibition; command or edict against athing. [Obs.]ow hast thou yield to transgress The strict forbiddance. Milton.
forbidden: Prohibited; interdicted.I kniw no spells, use no forbidden arts. Milton.Forbidden fruit. (a) Any coveted unlawful pleasure, -- so called withreference to the forbidden fruit of the Garden of Eden. (b) (Bot.) Asmall variety of shaddock (Citrus decumana). The name is given indifferent places to several varieties of Citrus fruits.
forbidding: Repelling approach; repulsive; raising abhorrence, aversion, ordislike; disagreeable; prohibiting or interdicting; as, a forbiddingaspect; a forbidding formality; a forbidding air.
forbore: imp. of Forbear.
forborne: p. p. of Forbear.
force: To stuff; to lard; to farce. [R.]Wit larded with malice, and malice forced with wit. Shak.
forced: Done or produced with force or great labor, or by extraordinaryexertion; hurried; strained; produced by unnatural effort orpressure; as, a forced style; a forced laugh. Forced draught. Seeunder Draught.-- Forced march (Mil.), a march of one or more days made with allpossible speed.-- For"ced*ly, adv.-- For"ced*ness, n.
forceful: Full of or processing force; exerting force; mighty.-- Force"ful*ly, adv.Against the steed he threw His forceful spear. Dryden.
forceless: Having little or no force; feeble.These forceless flowers like sturdy trees support me. Shak.
forceps: The caudal forceps-shaped appendage of earwigs and some otherinsects. See Earwig. Dressing forceps. See under Dressing.
forcibly: In a forcible manner.
ford: To pass or cross, as a river or other water, by wading; to wadethrough.His last section, which is no deep one, remains only to be forted.Milton.
fordable: Capable of being forded.-- Ford"a*ble*ness, n.
fore: Journey; way; method of proceeding. [Obs.] "Follow him and hisfore." Chaucer.
forearm: To arm or prepare for attack or resistance before the time ofneed. South.
forebear: An ancestor. See Forbear.
forebode: To fortell; to presage; to augur.If I forebode aright. Hawthorne.
foreboding: Presage of coming ill; expectation of misfortune.
forebodingly: In a foreboding manner.
forecast: To contrive or plan beforehand.If it happen as I did forecast. Milton.
forecaster: One who forecast. Johnson.
foreclose: To shut up or out; to preclude; to stop; to prevent; to bar; toexclude.The embargo with Spain foreclosed this trade. Carew.To foreclose a mortgager (Law), to cut him off by a judgment of courtfrom the power of redeeming the mortgaged premises, termed his equityof redemption.-- To foreclose a mortgage, (not technically correct, but often usedto signify) the obtaining a judgment for the payment of an overduemortgage, and the exposure of the mortgaged property to sale to meetthe mortgage debt. Wharton.
foreclosure: The act or process of foreclosing; a proceeding which bars orextinguishes a mortgager's right of redeeming a mortgaged estate.
foredoom: To doom beforehand; to predestinate.Thou art foredomed to view the Stygian state. Dryden.
forefather: One who precedes another in the line of genealogy in anydegree, but usually in a remote degree; an ancestor.Respecting your forefathers, you would have been taught to respectyourselves. Burke.Forefathers' Day, the anniversary of the day (December 21) on whichthe Pilgrim Fathers landed at Plymouth, Massachusetts (1620). Onaccount of a mistake in reckoning the change from Old Style to NewStyle, it has generally been celebrated on the 22d.
forefend: To hinder; to fend off; to avert; to prevent the approach of;to forbid or prohibit. See Forfend.God forefend it should ever be recorded in our history. Landor.It would be a far better work . . . to forefend the cruelty. I.Taylor.
forefinger: The finger next to the thumb; the index.
forefoot: A piece of timber which terminates the keel at the fore end,connecting it with the lower end of the stem.
forefront: Foremost part or place.Set ye Uriah in the forefront of the hottest battle. 2 Sam. xi. 15.Socrates, Plato, Aristotle, standing in the forefront for all time,the masters of those who know. J. C. Shairp.
foregather: Same as Forgather.
forego: To go before; to precede; -- used especially in the present andpast participles.Pleasing remembrance of a thought foregone. Wordsworth.For which the very mother's face forewent The mother's specialpatience. Mrs. Browning.Foregone conclusion, one which has preceded argument or examination;one predetermined.
foregoer: One who forbears to enjoy.
foreground: On a painting, and sometimes in a bas-relief, mosaic picture,or the like, that part of the scene represented, which is nearest tothe spectator, and therefore occupies the lowest part of the work ofart itself. Cf. Distance, n., 6.
forehand: Done beforehand; anticipative.And so extenuate the forehand sin. Shak.
foreigner: A person belonging to or owning allegiance to a foreigncountry; one not native in the country or jurisdiction underconsideration, or not naturalized there; an alien; a stranger.Joy is such a foreigner, So mere a stranger to my thoughts. Denham.Nor could the majesty of the English crown appear in a greaterluster, either to foreigners or subjects. Swift.
foreignness: The quality of being foreign; remoteness; want of relation orappropriateness.Let not the foreignness of the subject hinder you from endeavoring toset me right. Locke.A foreignness of complexion. G. Eliot.
foreknow: To have previous knowledge of; to know beforehand.Who would the miseries of man foreknow Dryden.
foreknowledge: Knowledge of a thing before it happens, or of whatever is tohappen; prescience.If I foreknew, Foreknowledge had no influence on their fault. Milton.
forelock: A cotter or split pin, as in a slot in a bolt, to preventretraction; a linchpin; a pin fastening the cap-square of a gun.Forelock bolt, a bolt retained by a key, gib, or cotter passingthrough a slot.-- Forelock hook (Rope Making), a winch or whirl by which a bunch ofthree yarns is twisted into a standard. Knight.-- To take time, or occasion, by the forelock, to make prompt use ofanything; not to let slip an opportunity.Time is painted with a lock before and bald behind, signifyingthereby that we must take time by the forelock; for when it is oncepast, there is no recalling it. Swift.On occasion's forelock watchful wait. Milton.
foreman: The first or chief man; as:(a) The chief man of a jury, who acts as their speaker.(b) The chief of a set of hands employed in a shop, or on works ofany kind, who superintends the rest; an overseer.
foremast: The mast nearest the bow. Foremast hand or man (Naut.), acommon sailor; also, a man stationed to attend to the gear of theforemast.
foremost: First in time or place; most advanced; chief in rank ordignity; as, the foremost troops of an army.THat struck the foremost man of all this world. Shak.
forename: A name that precedes the family name or surname; a first name.Selden.
forenamed: Named before; aforenamed.
forenoon: The early part of the day, from morning to meridian, or noon.
forensic: Belonging to courts of judicature or to public discussion anddebate; used in legal proceedings, or in public discussions;argumentative; rhetorical; as, forensic eloquence or disputes.Forensic medicine, medical jurisprudence; medicine in its relationsto law.
foreordain: To ordain or appoint beforehand; to preordain; to predestinate;to predetermine. Hooker.
foreordination: Previous ordination or appointment; predetermination;predestination.
forerunner: A piece of rag terminating the log line.
foresee: To have or exercise foresight. [Obs.]
foreseen: , or (strictly) p. p. Provided; in case that; on conditionthat. [Obs.]One manner of meat is most sure to every complexion, foreseen that itbe alway most commonly in conformity of qualities, with the personthat eateth. Sir T. Elyot.
foreseer: One who foresees or foreknows.
foreshadow: To shadow or typi Dryden.
foreshorten: To represent on a plane surface, as if extended in a directiontoward the spectator or nearly so; to shorten by drawing inperspective.
foresight: Any sight or reading of the leveling staff, except thebacksight; any sight or bearing taken by a compass or theodolite in aforward direction.
foresighted: Sagacious; prudent; provident for the future. Bartram.
foreskin: The fold of skin which covers the glans of the penis; theprepuce.
forest: A large extent or precinct of country, generally waste andwoody, belonging to the sovereign, set apart for the keeping of gamefor his use, not inclosed, but distinguished by certain limits, andprotected by certain laws, courts, and officers of its own. Burrill.
forestall: To obstruct or stop up, as a way; to stop the passage of onhighway; to intercept on the road, as goods on the way to market. Toforestall the market, to buy or contract for merchandise or provisionon its way to market, with the intention of selling it again at ahigher price; to dissuade persons from bringing their goods orprovisions there; or to persuade them to enhance the price whenthere. This was an offense at law in England until 1844. Burrill.
forester: A lepidopterous insect belonging to Alypia and allied genera;as, the eight-spotted forester (A. octomaculata), which in the larvalstate is injurious to the grapevine.
forestry: The art of forming or of cultivating forests; the management ofgrowing timber.
foretaste: A taste beforehand; enjoyment in advance; anticipation.
foretell: To predict; to tell before occurence; to prophesy; to foreshow.Deeds then undone my faithful tongue foretold. Pope.Prodigies, foretelling the future eminence and luster of hischaracter. C. Middleton.
foreteller: One who predicts. Boyle.
forethought: Thought of, or planned, beforehand; aforethought; prepense;hence, deliberate. "Forethought malice." Bacon.
foretoken: Prognostic; previous omen. Sir P. Sidney.
foretop: The platform at the head of the foremast.
forewarn: To warn beforehand; to give previous warning, admonition,information, or notice to; to caution in advance.We were forewarned of your coming. Shak.
forewoman: A woman who is chief; a woman who has charge of the work orworkers in a shop or other place; a head woman. Tatler. W. Besant.
foreword: A preface. Furnvall.
forfeit: Lost or alienated for an offense or crime; liable to penalseizure.Thy wealth being forfeit to the state. Shak.To tread the forfeit paradise. Emerson.
forfeitable: Liable to be forfeited; subject to forfeiture.For the future, uses shall be subject to the statutes of mortmain,and forfeitable, like the lands themselves. Blackstone.
forfeiter: One who incurs a penalty of forfeiture.
forfend: To prohibit; to forbid; to avert. [Archaic]Which peril heaven forefend! Shak.
forgather: To convene; to gossip; to meet accidentally. [Scot.] Jamieson.Within that circle he forgathered with many a fool. Wilson.
forgave: imp. of Forgive.
forge: To move heavily and slowly, as a ship after the sails arefurled; to work one's way, as one ship in outsailing another; -- usedespecially in the phrase to forge ahead. Totten.And off she [a ship] forged without a shock. De Quincey.
forger: One who forges, makes, of forms; a fabricator; a falsifier.
forgetfully: In a forgetful manner.
forgettable: Liable to be, or that may be, forgotten. Carlyle.
forging: A piece of forged work in metal; -- a general name for a pieceof hammered iron or steel.There are very few yards in the world at which such forgings could beturned out. London Times.
forgivable: Capable of being forgiven; pardonable; venial. Sherwood.
forgiver: One who forgives. Johnson.
forgiving: Disposed to forgive; inclined to overlook offenses; mild;merciful; compassionate; placable; as, a forgiving temper.-- For*giv"ing*ly, adv.-- For*giv"ing*ness, n. J. C. Shairp.
forgo: To pass by; to leave. See 1st Forego.For sith [since] I shall forgoon my liberty At your request. Chaucer.And four [days] since Florimell the court forwent. Spenser.
forgot: imp. & p. p. of Forget.
forgotten: p. p. of Forget.
fork: To raise, or pitch with a fork, as hay; to dig or turn overwith a fork, as the soil.Forking the sheaves on the high-laden cart. Prof. Wilson.To fork over or out, to hand or pay over, as money. [Slang] G. Eliot.
forlornly: In a forlorn manner. Pollok.
forlornness: State of being forlorn. Boyle.
form: A suffix used to denote in the form or shape of, resembling,etc.; as, valiform; oviform.
formaldehyde: A colorless, volatile liquid, H2CO, resembling acetic or ethylaldehyde, and chemically intermediate between methyl alcohol andformic acid.
formalism: The practice or the doctrine of strict adherence to, ordependence on, external forms, esp. in matters of religion.Official formalism. Sir H. Rawlinson.
formalist: One overattentive to forms, or too much confined to them; esp.,one who rests in external religious forms, or observes strictly theoutward forms of worship, without possessing the life and spirit ofreligion.As far a formalist from wisdom sits, In judging eyes, as libertinesfrom wits. Young.
formality: The dress prescribed for any body of men, academical,municipal, or sacerdotal. [Obs.]The doctors attending her in their formalities as far as Shotover.Fuller.
formalize: To affect formality. [Obs.] ales.
formally: In a formal manner; essentially; characteristically; expressly;regularly; ceremoniously; precisely.That which formally makes this [charity] a Christian grace, is thespring from which it flows. Smalridge.You and your followers do stand formally divided against theauthorized guides of the church and rest of the people. Hooker.
format: The shape and size of a book; hence, its external form.
formation: The arrangement of a body of troops, as in a square, column,etc. Farrow.
formative: Serving to form; derivative; not radical; as, a terminationmerely formative.
formerly: In time past, either in time immediately preceding or at anyindefinite distance; of old; heretofore.
formic: Pertaining to, or derived from, ants; as, formic acid; in anextended sense, pertaining to, or derived from, formic acid; as,formic ether. Amido formic acid, carbamic acid.-- Formic acid, a colorless, mobile liquid, HCO.OH, of a sharp, acidtaste, occurring naturally in ants, nettles, pine needles, etc., andproduced artifically in many ways, as by the oxidation of methylalcohol, by the reduction of carbonic acid or the destructivedistillation of oxalic acid. It is the first member of the fattyacids in the paraffin series, and is homologous with acetic acid.
formica: A Linnæan genus of hymenopterous insects, including the commonants. See Ant.
formication: A sensation resembling that made by the creeping of ants on theskin. Dunglison.
formidability: Formidableness. Walpole.
formidable: Exciting fear or apprehension; impressing dread; adapted toexcite fear and deter from approach, encounter, or undertaking;alarming.They seemed to fear the formodable sight. Dryden.I swell my preface into a volume, and make it formidable, when yousee so many pages behind. Drydn.
formidableness: The quality of being formidable, or adapted to excite dread.Boyle.
formidably: In a formidable manner.
formless: Shapeless; without a determinate form; wanting regularity ofshape.-- Form"less*ly, adv.-- Form"less*ness, n.
formula: A written confession of faith; a formal statement of foctrines.
formulate: To reduce to, or express in, a formula; to put in a clear anddefinite form of statement or expression. G. P. Marsh.
formulation: The act, process, or result of formulating or reducing to aformula.
fornicate: To commit fornication; to have unlawful sexual intercourse.
fornicator: An unmarried person, male or female, who has criminalintercourse with the other sex; one guilty of fornication.
forsooth: In truth; in fact; certainly; very well; -- formerly used as anexpression of deference or respect, especially to woman; now usedironically or contemptuously.A fit man, forsooth, to govern a realm! Hayward.Our old English word forsooth has been changed for the French madam.Guardian.
forster: A forester. [Obs.] Chaucer.
forswear: To swear falsely; to commit perjury. Shak.
forswore: imp. of Forswear.
forsworn: p. p. of Forswear.
forsythia: A shrub of the Olive family, with yellow blossoms.
fort: A strong or fortified place; usually, a small fortified place,occupied only by troops, surrounded with a ditch, rampart, andparapet, or with palisades, stockades, or other means of defense; afortification.Detached works, depending solely on their own strength, belong to theclass of works termed forts. Farrow.
forte: Loudly; strongly; powerfully.
forth: Forth from; out of. [Archaic]Some forth their cabins peep. Donne.
forthcoming: Ready or about to appear; making appearance.
forthright: Straight forward; in a straight direction. [Archaic] Sir P.Sidney.
forthrightness: Straightforwardness; explicitness; directness. [Archaic]Dante's concise forthrightness of phrase. Hawthorne.
forthwith: As soon as the thing required may be done by reasonableexertion confined to that object. Bouvier.
fortieth: One of forty equal parts into which one whole is divided; thequotient of a unit divided by forty; one next in order after thethirty-ninth.
fortifier: One who, or that which, fortifies, strengthens, supports, orupholds.
fortify: To raise defensive works. Milton.
fortissimo: Very loud; with the utmost strength or loudness.
fortnight: The space of fourteen days; two weeks.
fortnightly: Occurring or appearing once in a fortnight; as, a fortnightlymeeting of a club; a fortnightly magazine, or other publication.-- adv.
fortress: A fortified place; a large and permanent fortification,sometimes including a town; a fort; a castle; a stronghold; a placeof defense or security.
fortuitous: Happening independently of human will or means of foresight;resulting from unavoidable physical causes. Abbott.
fortuity: Accident; chance; casualty. D. Forbes (1750).
fortunately: In a fortunate manner; luckily; successfully; happily.
fortune: To fall out; to happen.It fortuned the same night that a Christian, serving a Turk in thecamp, secretely gave the watchmen warning. Knolles.
forty: Four times ten; thirtynine and one more.
forward: An agreement; a covenant; a promise. [Obs.]Tell us a tale anon, as forward is. Chaucer.
forwarder: One employed in forwarding.
forwarding: The process of putting a book into its cover, and making itready for the finisher.
forwardly: Eagerly; hastily; obtrusively.
forwardness: The quality of being forward; cheerful readiness; promtness;as, the forwardness of Christians in propagating the gospel.
forwards: Same as Forward.
fossil: Like or pertaining to fossils; contained in rocks. whetherpetrified or not; as, fossil plants, shells. Fossil copal, a resinoussubstance, first found in the blue clay at Highgate, near London, andapparently a vegetable resin, partly changed by remaining in theearth.-- Fossil cork, flax, paper, or wood, varieties of amianthus.-- Fossil farina, a soft carbonate of lime.-- Fossil ore, fossiliferous red hematite. Raymond.
fossilization: The process of converting, or of being converted, into afossil.
foster: To be nourished or trained up together. [Obs.] Spenser.
fosterling: A foster child.
fought: imp. & p. p. of Fight.
foul: A bird. [Obs.] Chaucer.
foulard: A thin, washable material of silk, or silk and cotton,originally imported from India, but now also made elsewhere.
foully: In a foul manner; filthily; nastily; shamefully; unfairly;dishonorably.I foully wronged him; do forgive me, do. Gay.
foulness: The quality or condition of being foul.
found: imp. & p. p. of Find.
foundation: The lowest and supporting part or member of a wall, includingthe base course (see Base course (a), under Base, n.) and footingcourses; in a frame house, the whole substructure of masonry.
founder: One who founds, establishes, and erects; one who lays afoundation; an author; one from whom anything originates; one whoendows.
founding: The art of smelting and casting metals.
foundling: A deserted or exposed infant; a child found without a parent orowner. Foundling hospital, a hospital for foundlings.
fount: A font.
four: One more than three; twice two.
fourfold: Four times; quadruple; as, a fourfold division.He snall restore the lamb fourfold. 2 Sam. xii. 6.
fourscore: Four times twenty; eighty.
foursome: Consisting of four; requiring four participants. [Scot. orGolf]
foursquare: Having four sides and four equal angles. Sir W. Raleigh.
fourteen: Four and ten more; twice seven.
fourteenth: The octave of the seventh.
fourth: The interval of two tones and a semitone, embracing fourdiatonic degrees of the scale; the subdominant of any key. TheFourth, specifically, un the United States, the fourth day of July,the anniversary of the declaration of American independence; as, tocelebrate the Fourth.
fourthly: In the fourth place.
fowl: To catch or kill wild fowl, for game or food, as by shooting,or by decoys, nets, etc.Such persons as may lawfully hunt, fish, or fowl. Blackstone.Fowling piece, a light gun with smooth bore, adapted for the use ofsmall shot in killing birds or small quadrupeds.
fox: A carnivorous animal of the genus Vulpes, family Canidæ, ofmany species. The European fox (V. vulgaris or V. vulpes), theAmerican red fox (V. fulvus), the American gray fox (V. Virginianus),and the arctic, white, or blue, fox (V. lagopus) are well-knownspecies.
foxglove: Any plant of the genus Digitalis. The common English foxglove(Digitalis purpurea) is a handsome perennial or biennial plant, whoseleaves are used as a powerful medicine, both as a sedative anddiuretic. See Digitalis.Pan through the pastures oftentimes hath run To pluck the speckledfoxgloves from their stem. W. Browne.
foxhound: One of a special breed of hounds used for chasing foxes.
fracas: An uproar; a noisy quarrel; a disturbance; a brawl.
fraction: One or more aliquot parts of a unit or whole number; anexpression for a definite portion of a unit or magnitude. Common, orVulgar, fraction, a fraction in which the number of equal parts intowhich the integer is supposed to be divided is indicated by figuresor letters, called the denominator, written below a line, over whichis the numerator, indicating the number of these parts included inthe fraction; as -- Complex fraction, a fraction having a fraction ormixed number in the numerator or denominator, or in both. Davies &Peck.-- Compound fraction, a fraction of a fraction; two or morefractions connected by of.-- Continued fraction, Decimal fraction, Partial fraction, etc. Seeunder Continued, Decimal, Partial, etc.-- Improper fraction, a fraction in which the numerator is greaterthan the denominator.-- Proper fraction, a fraction in which the numerator is less thanthe denominator.
fractionally: By fractions or separate portions; as, to distill a liquidfractionally, that is, so as to separate different portions.
fractious: Apt to break out into a passion; apt to scold; cross; snappish;ugly; unruly; as, a fractious man; a fractious horse.
fracture: The breaking of a bone.
fragile: Easily broken; brittle; frail; delicate; easily destroyed.The state of ivy is tough, and not fragile. Bacon.
fragment: A part broken off; a small, detached portion; an imperfectpart; as, a fragment of an ancient writing.Gather up the fragments that remain. John vi. 12.
fragmental: Consisting of the pulverized or fragmentary material of rock,as conglomerate, shale, etc.
fragmentarily: In a fragmentary manner; piecemeal.
fragmentary: Composed of the fragments of other rocks.
fragmented: Broken into fragments.
fragrant: [fragrans. -antis, p.pr. of fragrare to emit a smell offragrance: cf. OF. fragrant. Affecting the olfactory nervesagreeably; sweet of smell; odorous; having or emitting an agreeableperfume.Fragrant the fertile earth After soft showers. Milton.
frail: A basket made of rushes, used chiefly for containing figs andraisins.
frailly: Weakly; infirmly.
frailness: Frailty.
frame: To construct by fitting and uniting the several parts of theskeleton of any structure; specifically, in woodwork, to put togetherby cutting parts of one member to fit parts of another. See Dovetail,Halve, v. t., Miter, Tenon, Tooth, Tusk, Scarf, and Splice.
framer: One who frames; as, the framer of a building; the framers ofthe Constitution.
franc: A silver coin of France, and since 1795 the unit of the Frenchmonetary system. It has been adopted by Belgium and Swizerland. It isequivalent to about nineteen cents, or ten pence, and is divided into100 centimes.
franchise: A particular privilege conferred by grant from a sovereign or agovernment, and vested in individuals; an imunity or exemption fromordinary jurisdiction; a constitutional or statutory right orprivilege, esp. the right to vote.Election by universal suffrage, as modified by the Constitution, isthe one crowning franchise of the American people. W. H. Seward.
franchisement: Release; deliverance; freedom. Spenser.
franciscan: Belonging to the Order of St. Francis of the Franciscans.Franciscan Brothers, pious laymen who devote themselves to usefulworks, such as manual labor schools, and other educationalinstitutions; -- called also Brothers of the Third Order of St.Francis.-- Franciscan Nuns, nuns who follow the rule of t. Francis, esp.those of the Second Order of St. Francis, -- called also Poor Claresor Minoresses.-- Franciscan Tertiaries, the Third Order of St. Francis.
frangibility: The state or quality of being frangible. Fox.
frangible: Capable of being broken; brittle; fragile; easily broken.
frank: A pigsty. [Obs.]
frankincense: A fragrant, aromatic resin, or gum resin, burned as an incensein religious rites or for medicinal fumigation. The best kinds nowcome from East Indian trees, of the genus Boswellia; a commoner sort,from the Norway spruce (Abies excelsa) and other coniferous trees.The frankincense of the ancient Jews is still unidentified.
frankish: Like, or pertaining to, the Franks.
franklin: An English freeholder, or substantial householder. [Obs.]Chaucer.The franklin, a small landholder of those days. Sir J. Stephen.
frankly: In a frank manner; freely.Very frankly he confessed his treasons. Shak.
frankness: The quality of being frank; candor; openess; ingenuousness;fairness; liberality.
frantic: Mad; raving; furious; violent; wild and disorderly; distracted.Die, frantic wretch, for this accursed deed! Shak.Torrents of frantic abuse. Macaulay.-- Fran"tic*al*ly, adv.-- Fran"tic*ly, adv. Shak.-- Fran"tic*ness, n. Johnson.
frappe: Iced; frozen; artificially cooled; as, wine frappé. -- n.
fraternal: Pf, pertaining to, or involving, brethren; becoming tobrothers; brotherly; as, fraternal affection; a fraternal embrace.-- Fra*ter"nal*ly, adv.An abhorred, a cursed, a fraternal war. Milton.Fraternal love and friendship. Addison.
fraternization: The act of fraternizing or uniting as brothers.I hope that no French fraternization . . . could so change the heartsof Englishmen. Burke.
fraternize: To associate or hold fellowship as brothers, or as men of likeoccupation or character; to have brotherly feelings.
fraternizer: One who fraternizes. Burke.
fratricidal: Of or pertaining to fratricide; of the nature of fratricide.
fratricide: One who murders or kills his own brother.
frau: In Germany, a woman; a married woman; a wife; -- as a title,equivalent to Mrs., Madam.
fraud: An intentional perversion of truth for the purpose of obtainingsome valuable thing or promise from another.
fraudulently: In a fraudulent manner.
fraught: A freight; a cargo. [Obs.] Shak.
fraulein: In Germany, a young lady; an unmarried woman; -- as a title,equivalent to Miss.
fray: Affray; broil; contest; combat.Who began this bloody fray Shak.
frazzle: To fray; to wear or pull into tatters or tag ends; to tatter; --used literally and figuratively. [Prov. Eng. & U. S.]
freak: To variegate; to checker; to streak. [R.]Freaked with many a mingled hue. Thomson.
freakish: Apt to change the mind suddenly; whimsical; capricious.It may be a question whether the wife or the woman was the morefreakish of the two. L'Estrange.Freakish when well, and fretful when she's sick. Pope.-- Freak"ish*ly, adv.-- Freak"ish*ness, n.
freckle: To spinkle or mark with freckle or small discolored spots; tospot.
freckled: Marked with freckles; spotted. "The freckled trout." Dryden.The freckled cowslip, burnet, and green clover. Shak.
freckly: Full of or marked with freckles; sprinkled with spots;freckled.
fred: Peace; -- a word used in composition, especially in propernames; as, Alfred; Frederic.
free: Certain or honorable; the opposite of base; as, free service;free socage. Burrill.
freebooter: One who plunders or pillages without the authority of nationalwarfare; a member of a predatory band; a pillager; a buccaneer; a searobber. Bacon.
freeborn: Born free; not born in vasssalage; inheriting freedom.
freedman: A man who has been a slave, and has been set free.
freehold: An estate in real property, of inheritance (in fee simple orfee tail) or for life; or the tenure by which such estate is held.Kent. Burrill. To abate into a freehold. See under Abate.
freeholder: The possessor of a freehold.
freely: In a free manner; without restraint or compulsion; abundantly;gratuitously.Of every tree of the garden thou mayst freely eat. Gen. ii. 16.Freely ye have received, freely give. Matt. x. 8.Freely they stood who stood, and fell who fell. Milton.Freely we serve Because we freely love. Milton.
freemason: One of an ancient and secret association or fraternity, said tohave been at first composed of masons or builders in stone, but nowconsisting of persons who are united for social enjoyment and mutualassistance.
freemasonry: The institutions or the practices of freemasons.
freeness: The state or quality of being free; freedom; liberty; openness;liberality; gratuitousness.
freestone: A stone composed of sand or grit; -- so called because it iseasily cut or wrought.
freethinker: One who speculates or forms opinions independently of theauthority of others; esp., in the sphere or religion, one who formsopinions independently of the authority of revelation or of thechurch; an unbeliever; -- a term assumed by deists and skeptics inthe eighteenth century.Atheist is an old-fashioned word: I'm a freethinker, child. Addison.
freethinking: Undue boldness of speculation; unbelief. Berkeley.-- a.
freewheel: A clutch fitted in the rear hub of a cycle, which engages therear sprocket with the rear wheel when the pedals are rotatedforwards, but permits the rear wheel to run on free from the rearsprocket when the pedals are stopped or rotated backwards.Freewheelcycles are usually fitted with hub brakes or rim brakes,operated by back pedaling.
freewill: Of or pertaining to free will; voluntary; spontaneous; as, afreewill offering. Frewill Baptists. See under Baptist.
freezable: Capable of being frozen.
freeze: A frieze. [Obs.]
freezer: One who, or that which, cools or freezes, as a refrigerator, orthe tub and can used in the process of freezing ice cream.
freezing: Tending to freeze; for freezing; hence, cold or distant inmanner.-- Frrez"ing*ly, adv. Freezing machine. See Ice machine, under Ice.-- Freezing mixture, a mixture (of salt and snow or of chemicalsalts) for producing intense cold.-- Freezing point, that degree of a thermometer at which a fluidbegins to freeze; -- applied particularly to water, whose freezingpoint is at 32º Fahr., and at 0º Centigrade.
freight: Employed in the transportation of freight; having to do withfreight; as, a freight car. Freight agent, a person employed by atransportation company to receive, forward, or deliver goods.-- Freight car. See under Car.-- Freight train, a railroad train made up of freight cars; --called in England goods train.
french: Of or pertaining to France or its inhabitants. French bean(Bot.), the common kidney bean (Phaseolus vulgaris).-- French berry (Bot.), the berry of a species of buckthorn (Rhamnuscatharticus), which affords a saffron, green or purple pigment.-- French casement (Arch.) See French window, under Window.-- French chalk (Min.), a variety of granular talc; -- used fordrawing lines on cloth, etc. See under Chalk.-- French cowslip (Bot.) The Primula Auricula. See Bear's-ear.-- French fake (Naut.), a mode of coiling a rope by running itbackward and forward in parallel bends, so that it may run freely.-- French honeysuckle (Bot.) a plant of the genus Hedysarum (H.coronarium); -- called also garland honeysuckle.-- French horn, a metallic wind instrument, consisting of a longtube twisted into circular folds and gradually expanding from themouthpiece to the end at which the sound issues; -- called in Francecor de chasse.-- French leave, an informal, hasty, or secret departure; esp., theleaving a place without paying one's debts.-- French pie Etym: [French (here used in sense of "foreign") + piea magpie (in allusion to its black and white color)] (Zoöl.), theEuropean great spotted woodpecker (Dryobstes major); -- called alsowood pie.-- French polish. (a) A preparation for the surface of woodwork,consisting of gums dissolved in alcohol, either shellac alone, orshellac with other gums added. (b) The glossy surface produced by theapplication of the above.-- French purple, a dyestuff obtained from lichens and used forcoloring woolen and silken fabrics, without the aid of mordants. Ure.-- French red rouge.-- French rice, amelcorn.-- French roof (Arch.), a modified form of mansard roof having anearly flat deck for the upper slope.-- French tub, a dyer's mixture of protochloride of tin and logwood;-- called also plum tub. Ure.-- French window. See under Window.
frenchman: A native or one of the people of France.
frenetic: Distracted; mad; frantic; phrenetic. Milton.
frenetical: Frenetic; frantic; frenzied.-- Frenet"ic*al*ly, adv.
frenum: A cheek stripe of color.
frenzied: Affected with frenzy; frantic; maddened.-- Fren"zied-ly, adv.The people frenzied by centuries of oppression. Buckle.Up starting with a frenzied look. Sir W Scott.
frenzy: Any violent agitation of the mind approaching to distraction;violent and temporary derangement of the mental faculties; madness;rage.All else is towering frenzy and distraction. Addison.The poet's eye in a fine frenzy rolling. Shak.
frequentative: Serving to express the frequent repetition of an action; as, afrequentative verb.-- n.
frequenter: One who frequents; one who often visits, or resorts tocustomarily.
frequently: At frequent or short intervals; many times; often; repeatedly;commonly.
frequentness: The quality of being frequent.
fresco: To paint in fresco, as walls.
fresh: To refresh; to freshen. [Obs.] Rom. of R.
freshen: To relieve, as a rope, by change of place where friction wearsit; or to renew, as the material used to prevent chafing; as, tofreshen a hawse. Totten. To freshen ballast (Naut.), to shift Orrestore it.-- To freshen the hawse, to pay out a little more cable, so as tobring the chafe on another part.-- To freshen the way, to increase the speed of a vessel. Ham. Nav.Encyc.
freshly: In a fresh manner; vigorously; newly, recently; brightly;briskly; coolly; as, freshly gathered; freshly painted; the windblows freshly.Looks he as freshly as he did Shak.
freshman: novice; one in the rudiments of knowledge; especially, astudent during his fist year in a college or university.He drank his glass and cracked his joke, And freshmen wondered as hespoke. Goldsmith.Freshman class, the lowest of the four classes in an Americancollege. [ U. S.]
freshness: The state of being fresh.The Scots had the advantage both for number and freshness of men.Hayward.And breathe the freshness of the open air. Dryden.Her cheeks their freshness lose and wonted grace. Granville.
fret: See 1st Frith.
fretful: Disposed to fret; ill-humored; peevish; angry; in a state ofvexation; as, a fretful temper.-- Fret"ful-ly, adv.-- Fret"ful-ness, n.
fretted: Interlaced one with another; -- said of charges and ordinaries.
fretter: One who, or that which, frets.
fretwork: Work adorned with frets; ornamental openwork or work in relief,esp. when elaborate and minute in its parts. Heuce, any minute playof light andshade, dark and light, or the like.Banqueting on the turf in the fretwork of shade and sunshine.Macaulay.
freya: The daughter of Njörd, aud goddess of love and beauty; theScandinavian Venus; -- in Teutonic myths confounded with Frigga, butin Scandinavian, distinct. [Written also Frea, Fraying, and Ereyja.]
friable: [friabilis, fr. friare to rub, break, or crumble into smallpieces, cf. fricare to rub, E. fray. cf. F. friable.) Easilycrumbled, pulverized, or reduced to powder. "Friable ground." Evelyn."Soft and friable texture." Paley.-- Fri'a-ble-ness, n.
friar: A brother or member of any religious order, but especially ofone of the four mendicant orders, viz: (a) Minors, Gray Friars, orFranciscans. (b) Augustines. (c) Dominicans or Black Friars. (d)White Friars or Carmelites. See these names in the Vocabulary.
friary: Like a friar; pertaining to friars or to a convent. [Obs.]Camden.
fricassee: A dish made of fowls, veal, or other meat of small animals cutinto pieces, and stewed in a gravy.
fricative: Produced by the friction or rustling of the breath, intonatedor unintonated, through a narrow opening between two of the mouthorgans; uttered through a close approach, but not with a completeclosure, of the organs of articulation, and hence capable of beingcontinued or prolonged; -- said of certain consonantal sounds, as f,v, s, z, etc.-- n.
friction: The resistance which a body meets with from the surface onwhich it moves. It may be resistance to sliding motion, or to rollingmotion.
frictional: Relating to friction; moved by friction; produced by friction;as, frictional electricity. Frictional gearing, wheels which transmitmotion by surface friction instead of teeth. The faces are sometimesmade more or less V-shaped to increase or decrease friction, asrequired.
frictionless: Having no friction.
friday: The sixth day of the week, following Thursday and precedingSaturday.
fridge: To rub; to fray. [Obs.] Sterne.
fried: imp. & p. p. of Fry.
friend: To act as the friend of; to favor; to countenance; to befriend.[Obs.]Fortune friends the bold. Spenser.
friendless: Destitute of friends; forsaken.-- Friend"less*ness, n.
friendlily: In a friendly manner. Pope.
friendliness: The condition or quality of being friendly. Sir P. Sidney.
friendly: In the manner of friends; amicably; like friends. [Obs.] Shak.In whom all graces that can perfect beauty Are friendly met. Beau. &Fl.
frier: One who fries.
frieze: A kind of coarse woolen cloth or stuff with a shaggy or tufted(friezed) nap on one side. "Robes of frieze." Goldsmith.
fright: To alarm suddenly; to shock by causing sudden fear; to terrify;to scare.Nor exile or danger can fright a brave spirit. Dryden.
frighten: To disturb with fear; to throw into a state of alarm or fright;to affright; to terrify.More frightened than hurt. Old Proverb.
frightfully: In a frightful manner; to a frightful dagree.
frightfulness: The quality of being frightful.
frigidly: In a frigid manner; coldly; dully; without affection.
frigidness: The state of being frigid; want of heat, vigor, or affection;coldness; dullness.
frill: To wrinkle; -- said of the gelatin film.
fringe: One of a number of light or dark bands, produced by theinterference of light; a diffraction band; -- called alsointerference fringe.
fringed: Furnished with a fringe. Fringed lear (Bot.), a leaf edged withsoft parallel hairs.
fringy: Aborned with fringes. Shak.
frippery: Trifling; contemptible.
frisian: Of or pertaining to Friesland, a province of the Netherlands;Friesic.
frisk: Lively; brisk; frolicsome; frisky. [Obs.] Bp. Hall.
frisker: One who frisks; one who leaps of dances in gayety; a wanton; aninconstant or unsettled person. Camden.
friskily: In a frisky manner.
friskiness: State or quality of being frisky.
frisky: Inclined to frisk; frolicsome; gay.He is too frisky for an old man. Jeffrey.
frivolity: The condition or quality of being frivolous; also, acts orhabits of trifling; unbecoming levity of disposition.
friz: To soften and make of even thickness by rubbing, as with pumicestone or a blunt instrument. Frizzing machine. (a) (Fabrics) Amachine for frizzing the surface of cloth. (b) (Wood Working) A benchwith a revolving cutter head slightly protruding above its surface,for dressing boards.
frizz: See Friz, v. t. & n.
frizzle: To curl or crisp, as hair; to friz; to crinkle. Gay. To frizzleup, to crinkle or crisp excessively.
fro: From; away; back or backward; -- now used only in oppositiontothe word to, in the phrase to and fro, that is, to and from. See Toand fro under To. Millon.
frog: 1. (Zoöl.) An amphibious animal of the genus Rana and relatedgenera, of many species. Frogs swim rapidly, and take long leaps onland. Many of the species utter loud notes in the springtime.
frolic: Full of levity; dancing, playing, or frisking about; full ofpranks; frolicsome; gay; merry.The frolic wind that breathes the spring. Milton.The gay, the frolic, and the loud. Waller.
frolicsome: Full of gayety and mirth; given to pranks; sportive.Old England, who takes a frolicsome brain fever once every two orthree years, for the benefit of her doctors. Sir W. Scott.-- Frol"ic*some*ly, adv.-- Frol"ic*some*ness, n.
from: Out of the neighborhood of; lessening or losing proximity to;leaving behind; by reason of; out of; by aid of; -- used wheneverdeparture, setting out, commencement of action, being, state,occurrence, etc., or procedure, emanation, absence, separation, etc.,are to be expressed. It is construed with, and indicates, the pointof space or time at which the action, state, etc., are regarded assetting out or beginning; also, less frequently, the source, thecause, the occasion, out of which anything proceeds; -- thearitithesis and correlative of to; as, it, is one hundred miles fromBoston to Springfield; he took his sword from his side; lightproceeds from the sun; separate the coarse wool from the fine; menhave all sprung from Adam, and often go from good to bad, and frombad to worse; the merit of an action depends on the principle fromwhich it proceeds; men judge of facts from personal knowledge, orfrom testimony.Experience from the time past to the time present. Bacon.The song began from Jove. Drpden.From high Mæonia's rocky shores I came. Addison.If the wind blow any way from shore. Shak.
frond: The organ formed by the combination or union into one body ofstem and leaf, and often bearing the fructification; as, the frond ofa fern or of a lichen or seaweed; also, the peculiar leaf of a palmtree.
front: Of or relating to the front or forward part; having a positionin front; foremost; as, a front view.
frontage: The front part of an edifice or lot; extent of front.
frontal: Belonging to the front part; being in front; esp. (Anat.),
frontier: An outwork. [Obs.]Palisadoes, frontiers, parapets. Shak.
frontiersman: A man living on the frontier.
frontispiece: The part which first meets the eye; as:(a) (Arch.) The principal front of a building. [Obs. or R.](b) An ornamental figure or illustration fronting the first page, ortitlepage, of a book; formerly, the titlepage itself.
frostbite: The freezing, or effect of a freezing, of some part of thebody, as the ears or nose. Kane.
frostily: In a frosty manner.
frostiness: State or quality of being frosty.
froth: To throw up or out spume, foam, or bubbles; to foam; as beerfroths; a horse froths.
frothily: In a frothy manner.
frothiness: State or quality of being frothy.
froufrou: A rustling, esp. the rustling of a woman's dress.
froward: Not willing to yield or compIy with what is required or isreasonable; perverse; disobedient; peevish; as, a froward child.A froward man soweth strife. Prov. xvi. 28.A froward retention of custom is as turbulent a thing as innovation.Bacon.
frown: To repress or repel by expressing displeasure or disapproval;to rebuke with a look; as, frown the impudent fellow into silence.
frowningly: In a frowning manner.
frowzy: Slovenly; unkempt; untidy; frouzy. "With head all frowzy."Spenser.The frowzy soldiers' wives hanging out clothes. W. D. Howells.
froze: imp. of Freeze.
fructify: To bear fruit. "Causeth the earth to fructify." Beveridge.
fructose: Fruit sugar; levulose. [R.]
fructuous: Fruitful; productive; profitable. [Obs.]Nothing fructuous or profitable. Chaucer.-- Fruc"tu*ous*ly, adv.-- Fruc"tu*ous*ness, n. [Obs.]
frugally: Thriftily; prudently.
frugalness: , n. Quality of being frugal; frugality.
fruit: The pulpy, edible seed vessels of certain plants, especiallythose grown on branches above ground, as apples, oranges, grapes,melons, berries, etc. See 3.
fruitful: Full of fruit; producing fruit abundantly; bearing results;prolific; fertile; liberal; bountiful; as, a fruitful tree, orseason, or soil; a fruitful wife.-- Fruit"ful*ly, adv.-- Fruit"ful*ness, n.Be fruitful and multiply and replenish the earth. Gen. i. 28.[Nature] By disburdening grows More fruitful. Milton.The great fruitfulness of the poet's fancy. Addison.
fruition: Use or possession of anything, especially such as isaccompanied with pleasure or satisfaction; pleasure derived frompossession or use. "Capacity of fruition." Rogers. "Godlikefruition." Milton.Where I may have fruition of her love. Shak.
fruity: Having the odor, taste, or appearance of fruit; also, fruitful.Dickens.
frump: To insult; to flout; to mock; to snub. [Obs.] Beau. & Fl.
frustrate: Vain; ineffectual; useless; unprofitable; null; voil; nugatory;of no effect. "Our frustrate search." Shak.
frustration: The act of frustrating; disappointment; defeat; as, thefrustration of one's designs
frustum: The part of a solid next the base, formed by cutting off the,top; or the part of any solid, as of a cone, pyramid, etc., betweentwo planes, which may be either parallel or inclined to each other.
fry: To cook in a pan or on a griddle (esp. with the use of fat,butter, or olive oil) by heating over a fire; to cook in boiling lardor fat; as, to fry fish; to fry doughnuts.
fuchsia: A genus of flowering plants having elegant drooping flowers,with four sepals, four petals, eight stamens, and a single pistil.They are natives of Mexico and South America. Double-floweredvarieties are now common in cultivation.
fuddle: To make foolish by drink; to cause to become intoxicated.[Colloq.]I am too fuddled to take care to observe your orders. Steele.
fudge: A made-up story; stuff; nonsense; humbug; -- often anexclamation of contempt.
fueler: One who, or that which, supplies fuel. [R.] [Written alsofueller.] Donne.
fugacious: Fleeting; lasting but a short time; -- applied particularly toorgans or parts which are short-lived as compared with the life ofthe individual.
fugaciousness: Fugacity. [Obs.]
fugue: A polyphonic composition, developed from a given theme orthemes, according to strict contrapuntal rules. The theme is firstgiven out by one voice or part, and then, while that pursues its way,it is repeated by another at the interval of a fifth or fourth, andso on, until all the parts have answered one by one, continuing theirseveral melodies and interweaving them in one complex progressivewhole, in which the theme is often lost and reappears.All parts of the scheme are eternally chasing each other, like theparts of a fugue. Jer. Taylor.
fuguist: A musician who composes or performs fugues. Busby.
fulcra: See Fulcrum.
fulcrum: That by which a lever is sustained, or about which it turns inlifting or moving a body.
fulfiller: One who fulfills. South.
fulgurant: Lightening. [R.] Dr. H. More.
fulgurate: To flash as lightning. [R.]
fulguration: The sudden brightening of a fused globule of gold or silver,when the last film of the oxide of lead or copper leaves its surface;-- also called blick.A phenomenon called, by the old chemists, fulguration. Ure.
full: Complete measure; utmost extent; the highest state or degree.The swan's-down feather, That stands upon the swell at full of tide.Shak.Full of the moon, the time of full moon.
fuller: One whose occupation is to full cloth. Fuller's earth, avariety of clay, used in scouring and cleansing cloth, to imbibegrease.-- Fuller's herb (Bot.), the soapwort (Saponaria officinalis),formerly used to remove stains from cloth.-- Fuller's thistle or weed (Bot.), the teasel (Dipsacus fullonum)whose burs are used by fullers in dressing cloth. See Teasel.
fulling: The process of cleansing, shrinking, and thickening cloth bymoisture, heat, and pressure. Fulling mill, a mill for fulling clothas by means of pesties or stampers, which alternately fall into andrise from troughs where the cloth is placed with hot water andfuller's earth, or other cleansing materials.
fullness: The state of being full, or of abounding; abundance;completeness. [Written also fulness.]"In thy presence is fullness of joy." Ps. xvi. 11.
fully: In a full manner or degree; completely; entirely; without lackor defect; adequately; satisfactorily; as, to be fully persuaded ofthe truth of a proposition. Fully committed (Law), committed toprison for trial, in distinction from being detained for examination.
fulminant: Thundering; fulminating. [R.] Bailey.
fulminatory: Thundering; striking terror. Cotgrave.
fulness: See Fullness.
fulvous: Tawny; dull yellow, with a mixture of gray and brown. Lindley.
fumarole: A hole or spot in a volcanic or other region, from which fumesissue.
fumble: To handle or manage awkwardly; to crowd or tumble together.Shak.
fumbler: One who fumbles.
fumblingly: In the manner of one who fumbles.
fumigant: Fuming. [R.]
fumigator: One who, or that which, fumigates; an apparattus forfumigating.
fumy: Producing fumes; fumous. "Drowned in fumy wine." H. Brooke.
fun: Sport; merriment; frolicsome amusement. "Oddity, frolic, andfun." Goldsmith. To make fan of, to hold up to, or turn into,ridicule.
funambulist: A ropewalker or ropedancer.
function: The appropriate action of any special organ or part of ananimal or vegetable organism; as, the function of the heart or thelimbs; the function of leaves, sap, roots, etc.; life is the sum ofthe functions of the various organs and parts of the body.
functional: Pertaining to the function of an organ or part, or to thefunctions in general. Functional disease (Med.), a disease of whichthe symptoms cannot be referred to any appreciable lesion or changeof structure; the derangement of an organ arising from a cause, oftenunknown, external to itself opposed to organic disease, in which theorgan itself is affected.
functionally: In a functional manner; as regards normal or appropriateactivity.The organ is said to be functionally disordered. Lawrence.
functionary: One charged with the performance of a function or office; as, apublic functionary; secular functionaries.
functionless: Destitute of function, or of an appropriate organ. Darwin.
fund: The stock of a national debt; public securities; evidences(stocks or bonds) of money lent to government, for which interest ispaid at prescribed intervals; -- called also public funds.
fundamental: Pertaining to the foundation or basis; serving for thefoundation. Hence: Essential, as an element, principle, or law;important; original; elementary; as, a fundamental truth; afundamental axiom.The fundamental reasons of this war. Shak.Some fundamental antithesis in nature. Whewell.Fundamental bass (Mus.), the root note of a chord; a bass formed ofthe roots or fundamental tones of the chords.-- Fundamental chord (Mus.), a chord, the lowest tone of which isits root.-- Fundamental colors, red, green, and violet-blue. See Primarycolors, under Color.
fundamentally: Primarily; originally; essentially; radically; at thefoundation; in origin or constituents. "Fundamentally defective."Burke.
funeral: Per. taining to a funeral; used at the interment of the dead;as, funeral rites, honors, or ceremonies. Shak. Funeral pile, astructure of combustible material, upon which a dead body is placedto be reduced to ashes, as part of a funeral rite; a pyre.-- Fu"ner*al*ly, adv. [Obs.] Sir T. Browne.
funereal: Suiting a funeral; pertaining to burial; solemn. Hence: Dark;dismal; mournful. Jer. Taylor.What seem to us but sad funereal tapers May be heaven's distantlamps. Longfellow.-- Fu*ne"re*al*ly, adv.
fungal: Of or pertaining to fungi.
fungi: See Fungus.
fungicide: Anything that kills fungi.-- Fun`gi*ci"dal, n.
fungus: Any one of the Fungi, a large and very complex group ofthallophytes of low organization, -- the molds, mildews, rusts,smuts, mushrooms, toadstools, puff balls, and the allies of each.
funicular: Pertaining to a funiculus; made up of, or resembling, afuniculus, or funiculi; as, a funicular ligament. Funicular action(Mech.), the force or action exerted by a rope in drawing togetherthe supports to which its ends are Fastened, when acted upon byforces applied in a direction transverse to the rope, as in thearcher's bow.-- Funicular curve. Same as Catenary.-- Funicular machine (Mech.), an apparatus for illustrating certainprinciples in statics, consisting of a cord or chain attached at oneend to a fixed point, and having the other passed over a pulley andsustaining a weight, while one or more other weights are suspendedfrom the cord at points between the fixed support and the pulley.-- Funicular polygon (Mech.), the polygonal figure assumed by a cordfastened at its extremities, and sustaining weights at differentpoints.
funk: An offensive smell; a stench. [Low]
funky: Pertaining to, or characterized by, great fear, or funking.[Colloq. Eng.]
funny: Droll; comical; amusing; laughable. Funny bone. See crazy bone,under Crazy.
fur: Articles of clothing made of fur; as, a set of furs for a lady(a collar, tippet, or cape, muff, etc.).Wrapped up in my furs. Lady M. W. Montagu.
furbelow: A plaited or gathered flounce on a woman's garment.
furbish: To rub or scour to brightness; to clean; to burnish; as, tofurbish a sword or spear. Shak.Furbish new the name of John a Gaunt. Shak.
furies: See Fury, 3.
furl: To draw up or gather into close compass; to wrap or roll, as asail, close to the yard, stay, or mast, or, as a flag, close to oraround its staff, securing it there by a gasket or line. Totten.
furlong: A measure of length; the eighth part of a mile; forty rods; twohundred and twenty yards.
furlough: Leave of abserice; especially, leave given to an offcer orsoldier to be absent from service for a certain time; also, thedocument granting leave of absence.
furnish: That which is furnished as a specimen; a sample; a supply.[Obs.] Greene.
furnisher: One who supplies or fits out.
furniture: A mixed or compound stop in an organ; -- sometimes calledmixture.
furore: Excitement; commotion; enthusiasm.
furrier: A dealer in furs; one who makes or sells fur goods.
furring: Double planking of a ship's side.
further: To a greater distance; in addition; moreover. See Farther.Carries us, I know not how much further, into familiar company. M.Arnold.They sdvanced us far as Eleusis and Thria; but no further. Jowett(Thucyd. ).Further off, not so near; apart by a greater distance.
furtherance: The act of furthering or helping forward; promotion;advancement; progress.I know that I shall abide and continue with you all for yourfurthersnce and joy of faith. Phil. i. 25.Built of furtherance and pursuing, Not of spent deeds, but of doing.Emerson.
furthermore: or conj. Moreover; besides; in addition to what has been said.
furthermost: Most remote; furthest.
furthest: superl. Most remote; most in advance; farthest. See Further, a.
furtive: Stolen; obtained or characterized by stealth; sly; secret;stealthy; as, a furtive look. Prior.A hasty and furtive ceremony. Hallam.
furtively: Stealthily by theft. Lover.
fury: A thief. [Obs.]Have an eye to your plate, for there be furies. J. Fleteher.
furze: A thorny evergreen shrub (Ulex Europæus), with beautiful yellowflowers, very common upon the plains and hills of Great Britain; --called also gorse, and whin. The dwarf furze is Ulex nanus.
furzy: bounding in, or overgrown with, furze; characterized by furze.Gay.
fuscous: Brown or grayish black; darkish.Sad and fuscous colors, as black or brown, or deep purple and thelike. Burke.
fuse: A tube or casing filled with combustible matter, by means ofwhich a charge of powder is ignited, as in blasting; -- called alsofuzee. See Fuze. Fuse hole, the hole in a shell prepared for thereception of the fuse. Farrow.
fusee: A small packet of explosive material with wire appendagesallowing it to be conveniently attached to a railroad track. It willexplode with a loud report when run over by a train, and is used toprovide a warning signal to the engineer.
fuselage: An elongated body or frame of an aëroplane or flying machine;sometimes, erroneously, any kind of frame or body. Many aëroplaneshave no fuselage, properly so called.
fusibility: The quality of being fusible.
fusible: CapabIe of being melted or liquefied. Fusible metal, any alloyof different metals capable of being easily fused, especially analloy of five parts of bismuth, three of lead, and two of tin, whichmelts at a temperature below that of boiling water. Ure.-- Fusible plug (Steam Boiler), a piece of easily fusible alloy,placed in one of the sheets and intended to melt and blow off thesteam in case of low water.
fusillade: A simultaneous discharge of firearms.
fusion: The union, or binding together, of adjacent parts or tissues.
fuss: To be overbusy or unduly anxious about trifles; to make abustle or ado. Sir W. Scott.
fussily: In a fussy manner. Byron.
fussiness: The quality of being fussy.
fussy: Making a fuss; disposed to make an unnecessary ado abouttrifles; overnice; fidgety.Not at all fussy about his personal appearance. R. G. White.
fustiness: A fusty state or quality; moldiness; mustiness; an ill smellfrom moldiness.
futilely: In a futile manner.
future: That is to be or come hereafter; that will exist at any timeafter the present; as, the next moment is future, to the present.Future tense (Gram.), the tense or modification of a verb whichexpresses a future act or event.
futurism: A movement or phase of post-impressionism (which see, below).
futurist: One who believes or maintains that the fulfillment of theprophecies of the Bible is to be in the future.
fuze: A tube, filled with combustible matter, for exploding a shell,etc. See Fuse, n. Chemical fuze, a fuze in which substances separateduntil required for action are then brought into contact, and unitingchemically, produce explosion.-- Concussion fuze, a fuze ignited by the striking of theprojectile.-- Electric fuze, a fuze which is ignited by heat or a sparkproduced by an electric current.-- Friction fuze, a fuze which is ignited by the heat evolved byfriction.-- Percussion fuze, a fuze in which the ignition is produced by ablow on some fulminating compound.-- Time fuze, a fuze adapted, either by its length or by thecharacter of its composition, to burn a certain time before producingan explosion.
fuzz: To make drunk. [Obs.] Wood.